Bedroom (on Bed)
The Living Room is east.

On Dresser is Clock.

You can also see Calender here.

You've just arrived at your new house a couple of hours ago but instantly crashed on your new bed when you got there. You just woke up from your nap and realized it's already 5:00 pm. Your girlfriend Ellie was going to come over to see the new place. You'd better start actually looking around now. It's a little run down but hey, what did you expect from craigslist. Too bad you can't afford a nicer place yet.

Inform Final Project
An Interactive Fiction by Nolan Chung
Release 1 / Serial number 130314 / Inform 7 build 6G60 (I6/v6.32 lib 6/12N) SD

Bedroom (on Bed)
The Living Room is east.

On Dresser is Clock.

You can also see Calender here.

>get off bed
You'd better get into some clean clothes before Ellie gets here.

>get in bed
You get onto Bed.

>get off bed
You get off Bed.

Bedroom
The Living Room is east.

On Dresser is Clock.

You can also see Bed and Calender here.

>get in bed
You get onto Bed.

* * *

>get off bed
You get off Bed.

Bedroom
The Living Room is east.

On Dresser is Clock.

You can also see Bed and Calender here.

>x dresser
(Dresser)
A small dresser in your bedroom. There is one big dresser drawer.

On Dresser is Clock.

* * *

>take off dirty pants
You take off Dirty Pants.

>put on clean shirt
(first taking Clean Shirt)

>put on clean pants
(first taking Clean Pants)

 You here the doorbell ring

>x door
(Front Door)
You see nothing special about Front Door.

>open front door
You open the front door and see Ellie standing there. 

"Hey you." she says, smiling before walking in. "Not the nicest place in the world," she remarks, "but I'm glad you finally found one."

>e
Kitchen
The Living Room is west.

You can see Table here.

>w
Living Room
The Bedroom is west. The Kitchen is east. The Front Door is north.

You can see Elle, Suitcase (empty), Front Door, Rug and Couch here.

>w
Bedroom
The Living Room is east.

On Dresser is Clock.

You can also see Bed and Calender here.

>open dresser
(Dresser)
That's not something you can open.

* * *

>x drawer
You see nothing special about Dresser Drawer.

* * *

>x rug
You can't see any such thing.

>e
Living Room
The Bedroom is west. The Kitchen is east.

You can see Rug here.

>rules on
Rules tracing now switched on. Type "rules off" to switch it off again, or "rules all" to include even rules which do not apply.

>x rug
[Rule "Instead of examining rug for the first time" applies.]
A hidden door under the rug? Cliche much.

>x rug
[Rule "standard examining rule" applies.]
[Rule "examine directions rule" applies.]
[Rule "examine containers rule" applies.]
[Rule "examine supporters rule" applies.]
[Rule "examine devices rule" applies.]
[Rule "examine undescribed things rule" applies.]
You see nothing special about Rug.

[Rule "report other people examining rule" applies.]

>take rug
[Rule "Instead of taking rug for the first time" applies.]
A hidden door under the rug? Clich much.

* * *

>e
(first getting off Bed)
You'd better get into some clean clothes before Ellie gets here.

Living Room
The Bedroom is west. The Kitchen is east. The Front Door is north.

You can see Suitcase (closed), Front Door, Rug and Couch here.

* * *

>put on clean pants
(first taking Clean Pants)

>x self
    You are wearing clean pants.

>put on clean shirt
(first taking Clean Shirt)

 You hear the doorbell ring

* * *

>open door
(Front Door)
You open the front door and see Elle standing there. 

"Hey you, got your mail," she says, smiling before walking in. "Not the nicest place in the world," she remarks, "but I'm glad you finally found one-Ah!"

 She suddenly trips on the rug and drops the mail in her hand. You rush over and help her up. "Sorry about that," she laughs. "We should probably do something about the rug though. If not knowing me this'll definately happen again."

>x floor
You can't see any such thing.

>x mail
A letter from one of Elles old classmates. It's an invitation to a party she's having next week.

* * *

>x self
 You are wearing a dirty shirt.  You are wearing dirty pants.

* * *

>purloin elle
[Purloined.]

>i
You are carrying:
  Elle

>fuck that bitch
I only understood you as far as wanting to fuck.

>go down on elle
I only understood you as far as wanting to go down.

>oh.
That's not a verb I recognise.

>restart
Are you sure you want to restart?

* * *

>x east
You see nothing unexpected in that direction.

>s
You can't go that way.

>e
Living Room
The Bedroom is west. The Kitchen is east.

You can see Rug here.

>x rug
A hidden door under the rug? Cliche much.

>down
(first opening Hidden Door)

Basement
You can see Strange Mirror here.

>x mirror
You see a full body mirror on the wall, but something is not right. You don't see your reflection, only the rest of the room around you. Odd looks as if you could walk right through it.

* * *

>get out of bed
You'd better get into some clean clothes before Ellie gets here.

>get into bed
But you're already on Bed.

>get in bed
But you're already on Bed.

>get off bed
You'd better get into some clean clothes before Ellie gets here.

* * *

>get out of bed
You'd better get into some clean clothes before Ellie gets here.

>x dresser
(Dresser)
A small dresser in your bedroom. There is one big dresser drawer.

On Dresser is Clock.

>open dresser
(Dresser)
That's not something you can open.

>open drawer
You haven't unpacked your things yet. Your clothes must be in your suitcase somewhere.

>e
Living Room
The Bedroom is west. The Kitchen is east. The Front Door is north.

You can see Suitcase (closed), Front Door, Rug and Couch here.

* * *

>open suitcase
You open Suitcase, revealing Clean Shirt and Clean Pants.

>take off shirt
(Dirty Shirt)
You take off Dirty Shirt.

* * *

>take off pants
(Dirty Pants)
You take off Dirty Pants.

>put on shirt
(Dirty Shirt)
You put on Dirty Shirt.

>put on pants
(Dirty Pants)
You put on Dirty Pants.

>take off pats
You can't see any such thing.

>take off pants
(Dirty Pants)
You take off Dirty Pants.

>take off shirt
(Dirty Shirt)
You take off Dirty Shirt.

>put on clean shirt
(first taking Clean Shirt)

>put on clean pants
(first taking Clean Pants)

>i
You are carrying:
  Clean Pants (being worn)
  Clean Shirt
  Dirty Pants
  Dirty Shirt

* * *

>e
Living Room
The Bedroom is west. The Kitchen is east. The Front Door is north.

You can see Suitcase (closed), Front Door, Rug and Couch here.

>ope suitcase
That's not a verb I recognise.

>open suitcase
You open Suitcase, revealing Clean Shirt and Clean Pants.

* * *

>take off dirty shirt
You take off Dirty Shirt.

>take off dirty shirt
You're not wearing that.

>take off dirty pants
You take off Dirty Pants.

>x self
   You are wearing a clean shirt.

>put on clean pantrs
You can't see any such thing.

>put on clean pants
(first taking Clean Pants)

 You hear the doorbell ring

>x door
(Front Door)
You see nothing special about Front Door.

>open door
(Front Door)
You open the front door and see Elle standing there. 

"Hey you, got your mail," she says, smiling before walking in. "Not the nicest place in the world," she remarks, "but I'm glad you finally found one-Ah!"

 She suddenly trips on the rug and drops the mail in her hand. You rush over and help her up. "Sorry about that," she laughs. "We should probably do something about the rug though. If not knowing me this'll definately happen again."

>move rug
Nothing obvious happens.

>x rug
A hidden door under the rug? Cliche much.

>xyzzy
That's not a verb I recognise.

* * *

>x dresser
(Dresser)
A small dresser in your bedroom. There is one big dresser drawer.

On Dresser is Clock.

>x drawer
You see nothing special about Dresser Drawer.

>open drawer
You haven't unpacked your things yet. Your clothes must be in your suitcase somewhere.

* * *

>e
Living Room
The Bedroom is west. The Kitchen is east. The Front Door is north.

You can see Suitcase (closed), Front Door, Rug and Couch here.

>take off dirty shirt
You take off Dirty Shirt.

* * *

>put on clean shirt
(first taking Clean Shirt)

>put on clean pants
(first taking Clean Pants)

 You hear the doorbell ring

>open door
(Front Door)
You open the front door and see Elle standing there. 

"Hey you, got your mail," she says, smiling before walking in. "Not the nicest place in the world," she remarks, "but I'm glad you finally found one-Ah!"

 She suddenly trips on the rug and drops the mail in her hand. You rush over and help her up. "Sorry about that," she laughs. "We should probably do something about the rug though. If not knowing me this'll definately happen again."

>x rug
A hidden door under the rug? Cliche much.

* * *

>open hidden door
You open Hidden Door.

>down
Basement
You can see Mirror here.

>x mirror
You see a full body mirror on the wall, but something is not right. You don't see your reflection, only the rest of the room around you. Odd looks as if you could walk right through it.

* * *

>go mirror
Odd Everything seems to be the same. But something definately feels different.

>close
What do you want to close?

>mirror
You close Mirror.

>open mirror
You open Mirror.

>up
(first opening Hidden Door)

Living Room
You can see Hidden Door here.

* * *

>gonear ele
There seems to be no such object anywhere in the model world.

>gonear elle
Basement
You can see Mirror and Elle here.

>tak elle
That's not a verb I recognise.

>take elle
I don't suppose Elle would care for that.

* * *

>take bed
That's fixed in place.

* * *

>gonear basement
Basement
You can see Mirror and Elle here.

>talk to elle
hey baby, let's do it here ;)" you say, approaching her seductively.
"Oh babe, you read my mind" she says in response. BOW CHICA WOW WOWWWW

* * *

>get off of bed
You can't see any such thing.

>get out of bed
You'd better get into some clean clothes before Ellie gets here.

>get in bed
You get onto Bed.

>get out of bed
You get off Bed.

Bedroom
The Living Room is east.

On Dresser is Clock.

You can also see Bed and Calender here.

>open dresser drawer
You haven't unpacked your things yet. Your clothes must be in your suitcase somewhere.

>open dresser
(Dresser)
That's not something you can open.

* * *

>x clock
5:00 PM

* * *

>x calender
March 8, 2013

>e
(first getting off Bed)
You'd better get into some clean clothes before Ellie gets here.

Living Room
The Bedroom is west. The Kitchen is east.

You can see Suitcase (closed), Rug and Couch here.

* * *

>x dresser
(Dresser)
A small dresser in your bedroom. There is one big dresser drawer.

On Dresser is Alarm Clock.

>take alarm clock
Taken.

>x dresser
You see nothing special about Dresser.

>gonear bedroom1
Bedroom
On Dresser is Alarm Clock1.

You can also see Bed1 here.

>x alarm
(Alarm Clock)
You see nothing special about Alarm Clock.

>x clock
You see nothing special about Alarm Clock.

>gonear bedroom1
Bedroom
On Dresser is Alarm Clock1.

You can also see Bed1 here.

* * *

>x dresser
(Dresser)
A small dresser in your bedroom. There is one big dresser drawer.

On Dresser is Alarm Clock.

>open drawer
You open Dresser Drawer.

>x dresser drawer
Dresser Drawer is empty.