Bedroom (on Bed)
The Living Room is east.

You can see Dresser (closed), Clock and Calender here.

You arrived at your new house a couple of hours ago but instantly crashed on your new bed. You just woke up from your nap and realized it's already 5:00 pm. Your girlfriend Elle was going to come over to see the new place. You'd better start actually looking around now. It's a little run down but hey, what did you expect from craigslist. Too bad you can't afford a nicer place yet.

Inform Final Project
An Interactive Fiction by Nolan Chung
Release 1 / Serial number 130318 / Inform 7 build 6G60 (I6/v6.32 lib 6/12N) SD

Bedroom (on Bed)
The Living Room is east.

You can see Dresser (closed), Clock and Calender here.

>break dresser
Violence isn't the answer to this one.

* * *

>break
What do you want to break?

>door
You can't see any such thing.

>break dresser
Violence isn't the answer to this one.

>gonear mirror
Basement
A small and poorly lit space beneath the living room.

You can see Hidden Door and Mirror here.

>break mirror
Violence isn't the answer to this one.

>fuck
Real adventurers do not use such language.

* * *

>go e
(first getting off Bed)
You'd better get into some clean clothes before Elle gets here.

Living Room
The Bedroom is west. The Kitchen is east. The Front Door is north.

You can see Front Door, Suitcase (closed) and Couch here.

>take off clothes
You can't see any such thing.

* * *

>take off pants
You take off Dirty Pants.

>open suitcase
You open Suitcase, revealing Clean Shirt and Clean Pants.

* * *

>put on clean pants
(first taking Clean Pants)

You hear the doorbell ring.

>open door
(Front Door)
You open the front door and see Elle standing there. 

"Hey you, got your mail. There's an party invitation from Sarah." she says, smiling before walking in and looking around. "Not the nicest place in the world," she remarks, "but I'm glad you finally found one-Ah!"

 She suddenly trips on a rug and drops the mail in her hand. You rush over and help her up. "Sorry about that," she laughs. "We should probably do something about the rug though. If not, knowing me, this'll definately happen again."

>move rug
A hidden door under the rug? Cliche much.

>take mail
You don't need that right now.

>down
(first opening Hidden Door)
It seems to be locked.

>open door with key
(Front Door with Old Key)
That doesn't seem to be something you can unlock.

>open hidden door with key
You unlock Hidden Door.

>down
(first opening Hidden Door)

Basement
A small and poorly lit space beneath the living room.

You can see Mirror here.

>x mirror
You see a full body mirror on the wall, but something is not right. You don't see your reflection, only the rest of the room around you. Odd- looks as if you could walk right through it.

* * *

>go mirror
You walk through the mirror into a room exactly like the one you just left, but something definately feels different.

>up
Elle lets go of your hand and sits down on the couch. "Well that was anticlimactic," she says. "I thought maybe something cool would happen after going down there. Oh well, I'm thristy. Can you get me a drink? Maybe some of that root beer I love so much?"

Living Room
You can see Hidden Door, Couch (on which is Elle), Front Door and Mail here.

>w
Kitchen
You can see Table and Refrigerator (closed) here.

>open fridge
You open Refrigerator, revealing Root Beer and Pineapple Juice.

* * *

>take root beer
Suddenly you see Elle walk into the kitchen.

>give elle root beer
Elle takes the Pineapple Juice and says, "C'mon, you know I hate root beer. Oh could you also bring me the mail?"

* * *

>get out of bed
You'd better get into some clean clothes before Elle gets here.

I beg your pardon?

I beg your pardon?

>e
Living Room
The Bedroom is west. The Kitchen is east. The Front Door is north.

You can see Front Door, Suitcase (closed) and Couch here.

>e
Kitchen
The Living Room is west.

You can see Table and Refrigerator (closed) here.

>gonear basement
Basement
You can see Mirror here.

>go mirror
You walk through the mirror into a room exactly like the one you just left, but something definately feels different.

* * *

>up
Elle lets go of your hand and sits down on the couch. "Well that was anticlimactic," she says. "I thought maybe something cool would happen after going down there. Oh well, I'm thristy. Can you get me a drink? Maybe some of that root beer I love so much?"

Living Room
You can see Hidden Door, Couch (on which is Elle), Front Door and Mail here.

>e
Bedroom
You can see Bed, Dresser (empty), Clock and Calender here.

>w
Living Room
You can see Hidden Door, Couch (on which is Elle), Front Door and Mail here.

>w
Kitchen
You can see Table and Refrigerator (closed) here.

* * *

>get out of bed
You'd better get into some clean clothes before Elle gets here.

>take off shirt
You take off Dirty Shirt.

* * *

>take off pants
You take off Dirty Pants.

>e
Living Room
The Bedroom is west. The Kitchen is east. The Front Door is north.

You can see Front Door, Suitcase (closed) and Couch here.

>open suitcase
You open Suitcase, revealing Clean Shirt and Clean Pants.

>wear clean shirt
(first taking Clean Shirt)

>put on clean pants
(first taking Clean Pants)

You hear the doorbell ring.

* * *

>move rug
A hidden door under the rug? Cliche much.

>down
(first opening Hidden Door)

Elle grabs your hand and slowly follows you. "This is kind of creepy," she says.

Basement
You can see Elle and Mirror here.

>x mirror
You see a full body mirror on the wall, but something is not right. You don't see your reflection, only the rest of the room around you. Odd- looks as if you could walk right through it.

* * *

>go mirror
You walk through the mirror into a room exactly like the one you just left, but something definately feels different.

>go up
Elle lets go of your hand and sits down on the couch. "Well that was anticlimactic," she says. "I thought maybe something cool would happen after going down there. Oh well, I'm thristy. Can you get me a drink? Maybe some of that root beer I love so much?"

Living Room
You can see Hidden Door, Couch (on which is Elle), Front Door and Mail here.

>w
Kitchen
You can see Table and Refrigerator (closed) here.

>ope nfridge
That's not a verb I recognise.

>open fridge
You open Refrigerator, revealing Root Beer and Pineapple Juice.

* * *

>give root beer to elle
Elle takes the Pineapple Juice and says, "C'mon, you know I hate root beer. Oh could you also bring me the mail?"

>go e
"Hey did you bring me my root beer?" asks Elle.

Living Room
You can see Hidden Door, Couch (on which is Elle), Front Door and Mail here.

>x elle
 Elle is relaxing on your couch.

>x el
You can't see any such thing.

>x ell
You can't see any such thing.

>x elle
 Elle is relaxing on your couch.

>i
You are carrying:
  Root Beer
  Clean Pants (being worn)
  Clean Shirt (being worn)
  Dirty Pants
  Dirty Shirt

* * *

>e
(first getting off Bed)
You'd better get into some clean clothes before Elle gets here.

Living Room
The Bedroom is west. The Kitchen is east. The Front Door is north.

You can see Front Door, Suitcase (closed) and Couch here.

* * *

>take off pants
You take off Dirty Pants.

>e
Kitchen
The Living Room is west.

You can see Table and Refrigerator (closed) here.

* * *

>open fridge
You open Refrigerator, revealing Root Beer and Pineapple Juice.

>w
Living Room
The Bedroom is west. The Kitchen is east. The Front Door is north.

You can see Front Door, Suitcase (closed) and Couch here.

* * *

>put on clean pants
(first taking Clean Pants)

You hear the doorbell ring.

>open door bell
You can't see any such thing.

>open door
(Front Door)
You open the front door and see Elle standing there. 

"Hey you, got your mail. There's an party invitation from Sarah." she says, smiling before walking in and looking around. "Not the nicest place in the world," she remarks, "but I'm glad you finally found one-Ah!"

 She suddenly trips on a rug and drops the mail in her hand. You rush over and help her up. "Sorry about that," she laughs. "We should probably do something about the rug though. If not, knowing me, this'll definately happen again."

* * *

>up
Living Room
The Bedroom is west. The Kitchen is east. The Front Door is north.

You can see Front Door, Mail, Rug, Suitcase (empty) and Couch here.

>e
Kitchen
The Living Room is west.

You can see Table and Refrigerator (in which are Root Beer and Pineapple Juice) here.

>w
Living Room
The Bedroom is west. The Kitchen is east. The Front Door is north.

You can see Front Door, Mail, Rug, Suitcase (empty) and Couch here.

>w
Bedroom
The Living Room is east.

You can see Bed, Dresser (closed), Clock and Calender here.

>open fridge
You can't see any such thing.

>take root beer
You can't see any such thing.

>give root beer to elle
You can't see any such thing.

>e
Living Room
The Bedroom is west. The Kitchen is east. The Front Door is north.

You can see Front Door, Mail, Rug, Suitcase (empty) and Couch here.

>give root beer to ell
You can't see any such thing.

>give elle root beer
You can't see any such thing.

>take mail
You don't need that right now.

>give mail to elle
You can't see any such thing.

>e
Kitchen
The Living Room is west.

You can see Table and Refrigerator (in which are Root Beer and Pineapple Juice) here.

>x clock
You can't see any such thing.

>take clock
You can't see any such thing.

>take calender
You can't see any such thing.

>x calender
You can't see any such thing.

>w
Living Room
The Bedroom is west. The Kitchen is east. The Front Door is north.

You can see Front Door, Mail, Rug, Suitcase (empty) and Couch here.

>talk to elle
You can't see any such thing.

>give elle calender
You can't see any such thing.

>give elle clock
You can't see any such thing.

>go down
Basement
You can see Mirror and Elle here.

* * *

>purloin other dimension
[Purloined.]

>i
You are carrying:
  Other Dimension
    Explanation
  Clean Pants (being worn)
  Clean Shirt (being worn)
  Dirty Pants
  Dirty Shirt

* * *

>e
(first getting off Bed)
You'd better get into some clean clothes before Elle gets here.

Living Room
The Bedroom is west. The Kitchen is east. The Front Door is north.

You can see Front Door, Suitcase (closed) and Couch here.

>take couch
That's fixed in place.

>e
Kitchen
The Living Room is west.

You can see Table and Refrigerator (closed) here.

* * *

>open fridge
You open Refrigerator, revealing Root Beer and Pineapple Juice.

>take root beer
You don't need that right now.

* * *

>gonaer
That's not a verb I recognise.

>gonear
What do you want to gonear?

>basement
Basement
You can see Mirror here.

>go mirror
You walk through the mirror into a room exactly like the one you just left, but something definately feels different.

* * *

>go up
Elle lets go of your hand and sits down on the couch. "Well that was anticlimactic," she says. "I thought maybe something cool would happen after going down there. Oh well, I'm thristy. Can you get me a drink? Maybe some of that root beer I love so much?"

Living Room
You can see Hidden Door, Couch (on which is Elle), Front Door and Mail here.

>go w
Kitchen
You can see Table and Refrigerator (closed) here.

>open fridge
You open Refrigerator, revealing Root Beer and Pineapple Juice.

* * *

>go e
"Hey did you bring me my root beer?" asks Elle.

Living Room
You can see Hidden Door, Couch (on which is Elle), Front Door and Mail here.

>take mail
Taken.

>give mail to elle
"Wait what?" Elle exclaimed. "This isn't what I brought in earlier? And I was just with Sarah the other day! Is this some kind of sick joke?"

>look
Living Room
You can see Hidden Door, Couch (on which is Elle) and Front Door here.

* * *

>gonear basement
Basement
A small and poorly lit space beneath the living room.

You can see Mirror here.

>go mirror
You walk through the mirror into a room exactly like the one you just left, but something definately feels different.

* * *

>take root beer
Suddenly you see Elle walk into the kitchen.

>talk to elle
"Hey, got anything to drink?" says Elle.

>give elle root beer
Elle takes the Pineapple Juice and says, "C'mon, you know I hate root beer. Oh could you also bring me the mail?"

>go e
"Hey did you bring me my root beer?" asks Elle.

Living Room
You can see Hidden Door, Couch (on which is Elle), Front Door and Mail here.

>give elle root beer
"Thanks! I don't know why but root beer is my favorite." says Elle.

>take mail
Taken.

>give mail to elle
"Wait what?" Elle exclaimed. "I was just with Sarah earlier today. Is this some kind of sick joke?"

I beg your pardon?

* * *

>w
Kitchen
You can see Table and Refrigerator (closed) here.

>open kitchen
You can't see any such thing.

>open fridge
You open Refrigerator, revealing Root Beer and Pineapple Juice.

* * *

>take root beer
Suddenly you see Elle walk into the kitchen.

>give elle root beer
Elle takes the Pineapple Juice and says, "C'mon on, you know I hate root beer. Oh could you also bring me the mail?"

>go e
Living Room
You can see Hidden Door, Couch (on which is Elle), Front Door and Mail here.

>take mail
Taken.

>i
You are carrying:
  Mail
  Root Beer
  Dirty Pants (being worn)
  Dirty Shirt (being worn)

* * *

>open fridge
You open Refrigerator, revealing Root Beer and Pineapple Juice.

>take pineapple juice
Taken.

>e
Living Room
You can see Hidden Door, Couch (on which is Elle), Front Door and Mail here.

>give pineapple juice to elle
"Hey now, I asked for some root beer." says Elle.

>w
Kitchen
You can see Table and Refrigerator (in which is Root Beer) here.

>take root beer
Suddenly you see Elle walk into the kitchen.

>give elle pineapple juice
"Oh thanks! Pineapple juice is totally my favorite," says Elle.

>e
Living Room
You can see Hidden Door, Couch (on which is Elle), Front Door and Mail here.

* * *

>go up
Elle lets go of your hand and sits down on the couch. "Well that was anticlimactic," she says. "I thought maybe something cool would happen after going down there. Oh well, I'm thristy. Can you get me a drink? Maybe some of that root beer I love so much?"

Living Room
You can see Hidden Door, Couch (on which is Elle), Front Door and Mail here.

>x elle
 Elle is relaxing on your couch.

* * *

>go mirror
You walk through the mirror into a room exactly like the one you just left, but something definately feels different.

>look
Basement
You can see Elle, Hidden Door and Mirror here.

>x elle
Your girlfriend Elle. She's kind of crazy but you love her.

>x elle
Your girlfriend Elle. She's kind of crazy but you love her.

>x self
 You are wearing a dirty shirt.  You are wearing dirty pants.

>up
Elle lets go of your hand and sits down on the couch. "Well that was anticlimactic," she says. "I thought maybe something cool would happen after going down there. Oh well, I'm thristy. Can you get me a drink? Maybe some of that root beer I love so much?"

Living Room
You can see Hidden Door, Couch (on which is Elle), Front Door and Mail here.

* * *

>e
Living Room
You can see Hidden Door, Couch (on which is Elle), Front Door and Mail here.

>give elle pineapple
"Hey now, I asked for some root beer." says Elle.

>w
Kitchen
You can see Table and Refrigerator (in which is Root Beer) here.

* * *

>take root beer
Suddenly you see Elle walk into the kitchen.

>give elle pineapple juice
"Oh thanks! Pineapple juice is totally my favorite," says Elle. "Oh could you get me the mail?"

>e
"Hey did you bring me my root beer?" asks Elle.

Living Room
You can see Hidden Door, Couch (on which is Elle), Front Door and Mail here.

>give elle root beer
"Thanks! I don't know why but root beer is my favorite." says Elle.

* * *

>take mail
Taken.

>give mail to elle
"Wait what?" Elle exclaimed. "This isn't what I brought in earlier? And I was just with Sarah the other day! Help me figure out what's going on here. Let me know if you discover anything!"

>look
Living Room
You can see Hidden Door, Couch (on which is Elle) and Front Door here.

>x elle
Your girlfriend Elle. She's kind of crazy but you love her.  Elle is relaxing on your couch.  Elle is happily enjoying her root beer

* * *

>gonear basement1
Basement
You can see Mirror here.

* * *

>i
You are carrying:
  Dirty Pants (being worn)
  Dirty Shirt (being worn)
  Old Key