Bedroom (on Bed)
The Living Room is east.

You can see Dresser (closed), Clock and Calendar here.

You arrived at your new house a couple of hours ago but instantly crashed on your new bed. You just woke up from your nap and realized it's already 5:00 pm. Your girlfriend Elle was going to come over to see the new place. You'd better start actually looking around now. It's a little run down but hey, what did you expect from craigslist. Too bad you can't afford a nicer place yet.

Inform Final Project
An Interactive Fiction by Nolan Chung
Release 1 / Serial number 120320 / Inform 7 build 6G60 (I6/v6.32 lib 6/12N) SD

Bedroom (on Bed)
The Living Room is east.

You can see Dresser (closed), Clock and Calendar here.

>purloin other dimension
[Purloined.]

>i
You are carrying:
  Other Dimension
    Explanation
  Dirty Pants (being worn)
  Dirty Shirt (being worn)
  Old Key

>gonear basement
Basement
A small and poorly lit space beneath the living room.

You can see Mirror here.

* * *

>die
That's not a verb I recognise.

* * *

>take all
Nope.
I didn't understand that sentence.

* * *

>Open Dresser
You haven't unpacked your things yet. Your clothes must be in your suitcase somewhere.

>Unpack suitcase
That's not a verb I recognise.

>Open suitcase
You can't see any such thing.

>look
Bedroom (on Bed)
The Living Room is east.

You can see Dresser (closed), Clock and Calender here.

>Examine Dresser
A small dresser in your bedroom. It has one drawer.

>Open drawer
You haven't unpacked your things yet. Your clothes must be in your suitcase somewhere.

>Examine Clock
5:00 PM

>Examine Calendar
You can't see any such thing.

>Examine Calendar
You can't see any such thing.

>Examine Calender
March 8, 2013

* * *

That's not a verb I recognise.

>>
That's not a verb I recognise.

* * *

>open dresser
You haven't unpacked your things yet. Your clothes must be in your suitcase somewhere.

>open suitcase
You can't see any such thing.

>go to living room
You can't see any such thing.

>help
That's not a verb I recognise.

>look
Bedroom (on Bed)
The Living Room is east.

You can see Dresser (closed), Clock and Calendar here.

>commands
That's not a verb I recognise.

>open
What do you want to open?

>suitcase
You can't see any such thing.

>open
What do you want to open?

>door
You can't see any such thing.

>open
What do you want to open?

>dresser
You haven't unpacked your things yet. Your clothes must be in your suitcase somewhere.

>look at calendar
March 8, 2013

>check pockets
You can't see any such thing.

>kick
That's not a verb I recognise.

>return
That's not a verb I recognise.

>go
You'll have to say which compass direction to go in.

>go east
(first getting off Bed)
You'd better get into some clean clothes before Elle gets here.

Living Room
The Bedroom is west. The Kitchen is east. The Front Door is north.

You can see Front Door, Suitcase (closed) and Couch here.

>open suitcase
You open Suitcase, revealing Clean Shirt and Clean Pants.

>take shirt and pants
Dirty Shirt: You already have that.
Dirty Pants: You already have that.

>change pants
That's not a verb I recognise.

>wear clean shirt
(first taking Clean Shirt)

>Put On Clean Shirt
You're already wearing that!

>wear clean pants
(first taking Clean Pants)

You hear the doorbell ring.

>sit on couch
You get onto Couch.

You hear the doorbell ring.

>go west
(first getting off Couch)

Bedroom
The Living Room is east.

You can see Bed, Dresser (closed), Clock and Calendar here.

You hear the doorbell ring.

>open dresser
You haven't unpacked your things yet. Your clothes must be in your suitcase somewhere.

You hear the doorbell ring.

>get on bed
You get onto Bed.

You hear the doorbell ring.

>sleep
You aren't feeling especially drowsy.

You hear the doorbell ring.

>go west
(first getting off Bed)
You can't go that way.

You hear the doorbell ring.

>go east
Living Room
The Bedroom is west. The Kitchen is east. The Front Door is north.

You can see Front Door, Suitcase (empty) and Couch here.

You hear the doorbell ring.

>go to kitchen
You can't see any such thing.

>go east
Kitchen
The Living Room is west.

You can see Table and Refrigerator (closed) here.

You hear the doorbell ring.

>open refrigerator
You open Refrigerator, revealing Root Beer and Pineapple Juice.

You hear the doorbell ring.

>drink root beer
There's nothing suitable to drink here.

You hear the doorbell ring.

>drink drinks
You can't see any such thing.

>close refrigerator
You close Refrigerator.

You hear the doorbell ring.

>open refrigerator
You open Refrigerator, revealing Root Beer and Pineapple Juice.

You hear the doorbell ring.

* * *

>drink root beer
There's nothing suitable to drink here.

You hear the doorbell ring.

>consume root beer
That's not a verb I recognise.

>eat root beer
(first taking Root Beer)
You don't feel thirsty right now.

You hear the doorbell ring.

>eat pineapple juice
(first taking Pineapple Juice)
You don't feel thirsty right now.

You hear the doorbell ring.

>check pockets
You can't see any such thing.

>i
You are carrying:
  Clean Pants (being worn)
  Clean Shirt (being worn)
  Dirty Pants (being worn)
  Dirty Shirt (being worn)
  Old Key

You hear the doorbell ring.

>go south
You can't go that way.

You hear the doorbell ring.

>go west
Living Room
The Bedroom is west. The Kitchen is east. The Front Door is north.

You can see Front Door, Suitcase (empty) and Couch here.

You hear the doorbell ring.

>go west
Bedroom
The Living Room is east.

You can see Bed, Dresser (closed), Clock and Calendar here.

You hear the doorbell ring.

>open dresser
You haven't unpacked your things yet. Your clothes must be in your suitcase somewhere.

You hear the doorbell ring.

>go east
Living Room
The Bedroom is west. The Kitchen is east. The Front Door is north.

You can see Front Door, Suitcase (empty) and Couch here.

You hear the doorbell ring.

>go north
(first opening Front Door)
You open the front door and see Elle standing there. 

"Hey you, got your mail. There's an party invitation from Sarah." she says, smiling before walking in and looking around. "Not the nicest place in the world," she remarks, "but I'm glad you finally found one-Ah!"

 She suddenly trips on a rug and drops the mail in her hand. You rush over and help her up. "Sorry about that," she laughs. "We should probably do something about the rug though. If not, knowing me, this'll definately happen again."

>lift rug
That's not a verb I recognise.

>look at rug
A hidden door under the rug? Cliche much.

>look up
You see nothing unexpected in that direction.

>look right
You can't see any such thing.

>open door
(Front Door)
That's not something you can open.

>open hidden toor
I only understood you as far as wanting to open Hidden Door.

>open trapdoor
You can't see any such thing.

>look at hidden door
It's a hidden door made from the wood of the floor boards. It was covered by the rug.

>open hidden door
It seems to be locked.

>use key
That's not a verb I recognise.

>unlock hidden door
What do you want to unlock Hidden Door with?

>old key
You unlock Hidden Door.

>go north
(first opening Front Door)
That's not something you can open.

>go down
(first opening Hidden Door)

Elle grabs your hand and slowly follows you. "This is kind of creepy," she says.

Basement
A small and poorly lit space beneath the living room.

You can see Elle and Mirror here.

>kick mirro
That's not a verb I recognise.

>kick mirror
That's not a verb I recognise.

>kick elle
That's not a verb I recognise.

>hit mirror
Violence isn't the answer to this one.

>hit elle
Violence isn't the answer to this one.

>look at mirror
You see a full body mirror on the wall, but something is not right. You don't see your reflection, only the rest of the room around you. Odd- looks as if you could walk right through it.

>push elle through mirror
You can't see any such thing.

>throw pineapple juice at mirror
You can't see any such thing.

>take off clothes
You can't see any such thing.

>take dirty shirt off
You take off Dirty Shirt.

>take off clean shirt
You take off Clean Shirt.

>take off clean pants
You take off Clean Pants.

>take off dirty pants
You take off Dirty Pants.

>i
You are carrying:
  Clean Pants
  Clean Shirt
  Dirty Pants
  Dirty Shirt
  Old Key

>look at elle
Your girlfriend Elle. She's kind of crazy but you love her.

* * *

I beg your pardon?

>put on clean shirt
You're already wearing that!

* * *

>put on clean pants
You're already wearing that!

>put on dirty pants
You put on Dirty Pants.

>put on dirty shirt
You put on Dirty Shirt.

>go through mirror
You walk through the mirror into a room exactly like the one you just left, but something definately feels different.

>look
Basement
A small and poorly lit space beneath the living room.

You can see Elle, Hidden Door and Mirror here.

>look at elle
Your girlfriend Elle. She's kind of crazy but you love her.

>look up
You see nothing unexpected in that direction.

>look down
You see nothing unexpected in that direction.

>look at hands
You can't see any such thing.

>eat elle
(first taking Elle)
I don't suppose Elle would care for that.

>look at mirror
You see a full body mirror on the wall, but something is not right. You don't see your reflection, only the rest of the room around you. Odd- looks as if you could walk right through it.

>go up
Elle lets go of your hand and sits down on the couch. "Well that was anticlimactic," she says. "I thought maybe something cool would happen after going down there. Oh well, I'm thristy. Can you get me a drink? Maybe some of that root beer I love so much?"

Living Room
The Kitchen is west. The Bedroom is east.

You can see Hidden Door, Couch (on which is Elle), Front Door and Mail here.

>take mail
Taken.

>look at mail
It's a letter to attend Sarah Martin's funeral next weekend.

>go north
(first opening Front Door)
"Dude let's check out this house first. There's probs some monsters out there," laughs Elle.

>go west
Kitchen
The Living Room is east.

You can see Table and Refrigerator (closed) here.

>look table
You see nothing special about Table.

>look refrigerator
You see nothing special about Refrigerator.

>go east
Living Room
The Kitchen is west. The Bedroom is east.

You can see Hidden Door, Couch (on which is Elle) and Front Door here.

>look at couch
A white leather couch in the middle of the living room.

On Couch is Elle.

>move couce
You can't see any such thing.

>move couch
It is fixed in place.

>go east
Bedroom
The Living Room is west.

You can see Bed, Dresser (empty), Clock and Calendar here.

>look bed
You see nothing special about Bed.

>look dresser
Dresser is empty.

>look clock
13:27 AM

>look calendar
February 30, 2013.

>go west
Living Room
The Kitchen is west. The Bedroom is east.

You can see Hidden Door, Couch (on which is Elle) and Front Door here.

* * *

>go down
You can't go that way.

>kill elle
You can't see any such thing.

>look
Basement
A small and poorly lit space beneath the living room.

You can see Hidden Door and Mirror here.

>go through mirror
You walk through the mirror into a room exactly like the one you just left, but something definately feels different.

>go up
Living Room
The Bedroom is west. The Kitchen is east. The Front Door is north.

You can see Front Door, Mail, Rug, Suitcase (empty) and Couch here.

>look mail
(Mail)
It's a letter to attend Sarah Martin's funeral next weekend.

>look suitcase
The biggest suitcase you own filled with everything you could fit inside.

>take stuff
You can't see any such thing.

>look elle
You can't see any such thing.

>go west
Bedroom
The Living Room is east.

You can see Bed, Dresser (closed), Clock and Calendar here.

>go east
Living Room
The Bedroom is west. The Kitchen is east. The Front Door is north.

You can see Front Door, Mail, Rug, Suitcase (empty) and Couch here.

>go north
(first opening Front Door)
That's not something you can open.

>go east
Kitchen
The Living Room is west.

You can see Table and Refrigerator (in which are Root Beer and Pineapple Juice) here.

>go west
Living Room
The Bedroom is west. The Kitchen is east. The Front Door is north.

You can see Front Door, Mail, Rug, Suitcase (empty) and Couch here.

>go down
Basement
A small and poorly lit space beneath the living room.

You can see Mirror here.

>go up
Living Room
The Bedroom is west. The Kitchen is east. The Front Door is north.

You can see Front Door, Mail, Rug, Suitcase (empty) and Couch here.

>go west
Bedroom
The Living Room is east.

You can see Bed, Dresser (closed), Clock and Calendar here.

>look calendar
March 8, 2013

>go east
Living Room
The Bedroom is west. The Kitchen is east. The Front Door is north.

You can see Front Door, Mail, Rug, Suitcase (empty) and Couch here.

>go down
Basement
A small and poorly lit space beneath the living room.

You can see Mirror here.

>go through mirro
You can't see any such thing.

>go through mirror
You walk through the mirror into a room exactly like the one you just left, but something definately feels different.

>go up
Living Room
The Kitchen is west. The Bedroom is east.

You can see Hidden Door, Couch (on which is Elle) and Front Door here.

>look front door
You see nothing special about Front Door.

>kick elle
That's not a verb I recognise.

* * *

>smell elle
You smell nothing unexpected.

>sniff
You smell nothing unexpected.

>sniff bed
You can't see any such thing.

>take off shirt
Which do you mean, Clean Shirt or Dirty Shirt?

I beg your pardon?

>take off clean shirt
You take off Clean Shirt.

>take off dirty shirt
You take off Dirty Shirt.

>take off clean pants
You take off Clean Pants.

* * *

>take off dirty pants
You take off Dirty Pants.

>i
You are carrying:
  Mail
  Clean Pants
  Clean Shirt
  Dirty Pants
  Dirty Shirt
  Old Key

>look
Living Room
The Kitchen is west. The Bedroom is east.

You can see Hidden Door, Couch (on which is Elle) and Front Door here.

>go east
Bedroom
The Living Room is west.

You can see Bed, Dresser (empty), Clock and Calendar here.

>go onto bed
You can't see any such thing.

>go to bed
You can't see any such thing.

>get on bed
You get onto Bed.

>pose seductively
That's not a verb I recognise.

>look at calendar
February 30, 2013.

>take calendar
Taken.

>take clock
Taken.

>go west
(first getting off Bed)

Living Room
The Kitchen is west. The Bedroom is east.

You can see Hidden Door, Couch (on which is Elle) and Front Door here.

* * *

>go through mirro
You can't see any such thing.

* * *

>go up
Living Room
The Bedroom is west. The Kitchen is east. The Front Door is north.

You can see Front Door, Mail, Rug, Suitcase (empty) and Couch here.

>take suitcase
Taken.

>take mail
(Mail)
You don't need that right now.

>take rug
A hidden door under the rug? Cliche much.

>look mai
You can't see any such thing.

>look mail
(Mail)
It's a letter to attend Sarah Martin's funeral next weekend.

>i
You are carrying:
  Suitcase (open but empty)
  Clock
  Calendar
  Mail
  Clean Pants
  Clean Shirt
  Dirty Pants
  Dirty Shirt
  Old Key

>throw mail
(Mail)
Dropped.

>take mail
Which do you mean, Mail or Mail?

>take Mail
Which do you mean, Mail or Mail?

>take Mail
Which do you mean, Mail or Mail?

>take both
Mail: Taken.
Mail: You don't need that right now.
Rug: Taken.

>look
Living Room
The Bedroom is west. The Kitchen is east. The Front Door is north.

You can see Front Door, Mail and Couch here.

>go west
Bedroom
The Living Room is east.

You can see Bed, Dresser (closed), Clock and Calendar here.

>take calendar
(Calendar)
You don't feel like taking the Calendar right now.

>take clock
(Clock)
You don't feel like taking the clock right now.

>go east
Living Room
The Bedroom is west. The Kitchen is east. The Front Door is north.

You can see Front Door, Mail and Couch here.

>go down
Basement
A small and poorly lit space beneath the living room.

You can see Mirror here.

>go through mirror
You walk through the mirror into a room exactly like the one you just left, but something definately feels different.

* * *

>go up
Living Room
The Kitchen is west. The Bedroom is east.

You can see Hidden Door, Couch (on which is Elle) and Front Door here.

>go to couch
You can't see any such thing.

>get on couch
You get onto Couch.

On Couch you can see Elle.

* * *

>hi elle
That's not a verb I recognise.

>go wet
You can't see any such thing.

>go west
(first getting off Couch)

Kitchen
The Living Room is east.

You can see Table and Refrigerator (closed) here.

>inspect table
That's not a verb I recognise.

>look table
You see nothing special about Table.

* * *

>look refrigerator
You see nothing special about Refrigerator.

>open refrigerator
You open Refrigerator, revealing Root Beer and Pineapple Juice.

>take root beer
Suddenly you see Elle walk into the kitchen.

>take pineapple juice
Taken.

>take off clothes
You can't see any such thing.

>take off shirt
Which do you mean, Clean Shirt or Dirty Shirt?

>take off clean shirt
You're not wearing that.

* * *

>look elle
Your girlfriend Elle. She's kind of crazy but you love her.

>look
Kitchen
The Living Room is east.

You can see Elle, Table and Refrigerator (empty) here.

>take knife
You can't see any such thing.

>go east
Living Room
The Kitchen is west. The Bedroom is east.

You can see Hidden Door, Couch (on which is Elle) and Front Door here.

>look
Living Room
The Kitchen is west. The Bedroom is east.

You can see Hidden Door, Couch (on which is Elle) and Front Door here.

>go west
Kitchen
The Living Room is east.

You can see Elle, Table and Refrigerator (empty) here.

>look
Kitchen
The Living Room is east.

You can see Elle, Table and Refrigerator (empty) here.

>go east
Living Room
The Kitchen is west. The Bedroom is east.

You can see Hidden Door, Couch (on which is Elle) and Front Door here.

>go east
Bedroom
The Living Room is west.

You can see Bed and Dresser (empty) here.

>take bed
That's fixed in place.

>take dresser
Taken.

>open dresser
That's already open.

>i
You are carrying:
  Dresser (open but empty)
  Pineapple Juice
  Root Beer
  Rug
  Mail
  Suitcase (open but empty)
  Clock
  Calendar
  Clean Pants
  Clean Shirt
  Dirty Pants
  Dirty Shirt
  Old Key

>go west
Living Room
The Kitchen is west. The Bedroom is east.

You can see Hidden Door, Couch (on which is Elle) and Front Door here.

>go north
(first opening Front Door)
"Dude let's check out this house first. There's probs some monsters out there," laughs Elle.

>give mail to elle
"Wait what?" Elle exclaimed. "This isn't what I brought in earlier? And I was just with Sarah the other day! Help me figure out what's going on here. Let me know if you discover anything!"

>take mail
That seems to belong to Elle.

>give pineapple juice to elle
"Hey now, I asked for some root beer," says Elle.

>give root beer to elle
"Thanks! I don't know why but root beer is my favorite," says Elle.

>take root beer
That seems to belong to Elle.

>i
You are carrying:
  Dresser (open but empty)
  Pineapple Juice
  Rug
  Suitcase (open but empty)
  Clock
  Calendar
  Clean Pants
  Clean Shirt
  Dirty Pants
  Dirty Shirt
  Old Key

>drink pineapple juice
There's nothing suitable to drink here.

>throw rug
Dropped.

>take rug
Taken.

>hide elle in rug
That's not a verb I recognise.

>look
Living Room
The Kitchen is west. The Bedroom is east.

You can see Hidden Door, Couch (on which is Elle) and Front Door here.

>go wett
You can't see any such thing.

>go west
Kitchen
The Living Room is east.

You can see Elle, Table and Refrigerator (empty) here.

>open cupboard
You can't see any such thing.

>i
You are carrying:
  Rug
  Dresser (open but empty)
  Pineapple Juice
  Suitcase (open but empty)
  Clock
  Calendar
  Clean Pants
  Clean Shirt
  Dirty Pants
  Dirty Shirt
  Old Key

>go east
Living Room
The Kitchen is west. The Bedroom is east.

You can see Hidden Door, Couch (on which is Elle) and Front Door here.

>go east
Bedroom
The Living Room is west.

You can see Bed here.

>look
Bedroom
The Living Room is west.

You can see Bed here.

>go west
Living Room
The Kitchen is west. The Bedroom is east.

You can see Hidden Door, Couch (on which is Elle) and Front Door here.

>give calendar to elle
"Wait February 30? That doesn't make sense even with a leap year!" exclaims Elle. "This doesn't make any sense."

>i
You are carrying:
  Rug
  Dresser (open but empty)
  Pineapple Juice
  Suitcase (open but empty)
  Clock
  Clean Pants
  Clean Shirt
  Dirty Pants
  Dirty Shirt
  Old Key

>give elle clock
"What is up with this clock? This doesn't even make sense by 24 hour standards," says Elle with a suspicious look on her face.

"The mirror!" exclaims Elle. "Things started getting weird after we went down into the basement. It sounds crazy but that must be it!" 
Elle suddenly freezes. Her shocked expression locked on something behind you. You turn and suddenly see- Elle! in the kitchen glaring at both of you. Her stare is piercing, her teeth gritted, her stance wide. Your eyes only shift from her haunting expression to notice the large kitchen knife she's holding in her hand.

"It's- Me?!" the Elle next to you shrieks. She turns and looks at you, "I can see why you were probably so confused earlier," she says. 

"I don't know where you came from!" screamed the other Elle, "but He's staying here!" She suddenly begins slowly walking toward you, knife in hand. 

"We've got to get out of here!" pleads Elle, grabbing your arm. "C'mon!"

>kick fake elle
That's not a verb I recognise.

>throw clock
You haven't got that.

>throw dirty pants at elle
You lack the nerve when it comes to the crucial moment.

>throw dresser at elle
You lack the nerve when it comes to the crucial moment.

>throw pineapple juice
Dropped.

>take pineapple juice at elle
I only understood you as far as wanting to take Pineapple Juice.

>take juice
Taken.

>throw pinapple juice at elle
You can't see any such thing.

>go west
Kitchen
The Living Room is east.

You can see Elle, Table and Refrigerator (empty) here.

>go east
Living Room
The Kitchen is west. The Bedroom is east.

You can see Hidden Door, Couch (on which is Elle) and Front Door here.

* * *

>look
Living Room
The Kitchen is west. The Bedroom is east.

You can see Hidden Door, Couch (on which is Elle) and Front Door here.

>go east
Bedroom
The Living Room is west.

You can see Bed here.

>go west
Living Room
The Kitchen is west. The Bedroom is east.

You can see Hidden Door, Couch (on which is Elle) and Front Door here.

>go down
You and Elle rush down to the basement, slaming the hidden door shut behind you. Elle's hand is holding on tightly to yours as you make it all the way down. Suddenly the hidden door is flung open as other Elle runs down the stairs. "I said you can't have him!" she screams as she rushes down with the knife.

Basement
A small and poorly lit space beneath the living room.

You can see Elle, Elle, Hidden Door and Mirror here.

>punch elle
Who do you mean, Elle or Elle?

>elle
Who do you mean, Elle or Elle?

>Elle
Who do you mean, Elle or Elle?

>Elle1
Violence isn't the answer to this one.

>go through mirror
You and Elle find yourselves in the basement alone. You look at each other and feel a sudden sense of relief. However you both freeze again when you suddenly hear the other Elle screaming, "Stop! You can't have him!"

You walk through the mirror into a room exactly like the one you just left, but something definately feels different.

>look
Basement
A small and poorly lit space beneath the living room.

You can see Mirror and Elle here.

>go up
Living Room
The Bedroom is west. The Kitchen is east. The Front Door is north.

You can see Front Door, Mail and Couch here.

>take mail
You don't need that right now.

>go down
Basement
A small and poorly lit space beneath the living room.

You can see Mirror and Elle here.

>go through mirror
You and Elle find yourselves in the basement alone. You look at each other and feel a sudden sense of relief. However you both freeze again when you suddenly hear the other Elle screaming, "Stop! You can't have him!"

You walk through the mirror into a room exactly like the one you just left, but something definately feels different.

>go up
Living Room
The Kitchen is west. The Bedroom is east.

You can see Hidden Door, Couch and Front Door here.

>go down
You and Elle rush down to the basement, slaming the hidden door shut behind you. Elle's hand is holding on tightly to yours as you make it all the way down. Suddenly the hidden door is flung open as other Elle runs down the stairs. "I said you can't have him!" she screams as she rushes down with the knife.

Basement
A small and poorly lit space beneath the living room.

You can see Elle, Elle, Hidden Door and Mirror here.

>go through mirror
You and Elle find yourselves in the basement alone. You look at each other and feel a sudden sense of relief. However you both freeze again when you suddenly hear the other Elle screaming, "Stop! You can't have him!"

You walk through the mirror into a room exactly like the one you just left, but something definately feels different.

>go up
Living Room
The Bedroom is west. The Kitchen is east. The Front Door is north.

You can see Front Door, Mail and Couch here.

>go through front door
(first opening Front Door)
That's not something you can open.

>go east
Kitchen
The Living Room is west.

You can see Table and Refrigerator (in which are Root Beer and Pineapple Juice) here.

>take root beer
You don't feel thirsty right now.

>take pineapple juice
(Pineapple Juice)
You don't feel thirsty right now.

>go west
Living Room
The Bedroom is west. The Kitchen is east. The Front Door is north.

You can see Front Door, Mail and Couch here.

>go west
Bedroom
The Living Room is east.

You can see Bed, Dresser (closed), Clock and Calendar here.

>take dresser
(Dresser)
Taken.

>take clock
You don't feel like taking the clock right now.

>take calendar
You don't feel like taking the Calendar right now.

>look
Bedroom
The Living Room is east.

You can see Bed, Clock and Calendar here.

>go east
Living Room
The Bedroom is west. The Kitchen is east. The Front Door is north.

You can see Front Door, Mail and Couch here.

>read mail
Sarah Martin is a friend of Elle's. She's inviting you two to a party next weekend. You don't like her much but don't mind going along so long as you're with Elle.

>take ail
You can't see any such thing.

>take mail
You don't need that right now.

I beg your pardon?

>go north
(first opening Front Door)
That's not something you can open.

>go up
You can't go that way.

>look up
You see nothing unexpected in that direction.

>give root beer to elle
You can't see any such thing.

>i
You are carrying:
  Dresser (closed)
  Pineapple Juice
  Rug
  Dresser (open but empty)
  Suitcase (open but empty)
  Clean Pants
  Clean Shirt
  Dirty Pants
  Dirty Shirt
  Old Key

>take rug
You already have that.

>go down
Basement
A small and poorly lit space beneath the living room.

You can see Mirror and Elle here.

>do through mirror
That's not a verb I recognise.

>go through mirror
You and Elle find yourselves in the basement alone. You look at each other and feel a sudden sense of relief. However you both freeze again when you suddenly hear the other Elle screaming, "Stop! You can't have him!"

You walk through the mirror into a room exactly like the one you just left, but something definately feels different.

* * *

>go up
Living Room
The Bedroom is west. The Kitchen is east. The Front Door is north.

You can see Front Door, Mail and Couch here.

>look up
You see nothing unexpected in that direction.

>sit on couch
You get onto Couch.

>get off couch
You get off Couch.

Living Room
The Bedroom is west. The Kitchen is east. The Front Door is north.

You can see Front Door, Mail and Couch here.

>go north
(first opening Front Door)
That's not something you can open.

>go down
Basement
A small and poorly lit space beneath the living room.

You can see Mirror and Elle here.

>break mirror
Violence isn't the answer to this one.

>x mirror
You don't see your reflections, but what you do see is other Elle running toward you with the knife. Her image is getting bigger and bigger as it seemingly drawers nearer and nearer.

* * *

>gonear mirror
Basement
A small and poorly lit space beneath the living room.

You can see Hidden Door and Mirror here.

>go mirror
You walk through the mirror into a room exactly like the one you just left, but something definately feels different.

Elle grabs your hand and slowly follows you. "This is kind of creepy," she says.

* * *

>x clean shirt
You can't see any such thing.

* * *

>e
(first getting off Bed)
You'd better get into some clean clothes before Elle gets here.

Living Room
The Bedroom is west. The Kitchen is east. The Front Door is north.

You can see Front Door, Suitcase (closed) and Couch here.

>take off shirt
You take off Dirty Shirt.

>take off clothes
You can't see any such thing.

>take off pants
Well now you're not wearing any clothes! Get dressed!

>open suitcase
You open Suitcase, revealing Clean Shirt and Clean Pants.

>put on clean shirt
(first taking Clean Shirt)

>put on clean pants
(first taking Clean Pants)

You hear the doorbell ring.

>open door
(Front Door)
You open the front door and see Elle standing there. 

"Hey you, got your mail. There's an party invitation from Sarah." she says, smiling before walking in and looking around. "Not the nicest place in the world," she remarks, "but I'm glad you finally found one-Ah!"

 She suddenly trips on a rug and drops the mail in her hand. Huh, didn't even notice that there on the floor. You rush over and help her up. "Sorry about that," she laughs. "We should probably do something about the rug though. If not, knowing me, this'll definitely happen again."

>e
Kitchen
The Living Room is west.

You can see Table (on which is Old Key) and Refrigerator (closed) here.

* * *

>w
Living Room
The Bedroom is west. The Kitchen is east. The Front Door is north. There is a hidden door in the floor.

You can see Front Door, Mail, Elle, Rug, Suitcase (empty) and Couch here.

>down
You can't go that way.

>move rug
A hidden door under the rug? Cliche much.

>down
(first opening Hidden Door)
It seems to be locked.

>unlock hidden door with key
You unlock Hidden Door.

>down
(first opening Hidden Door)

Basement
A small and poorly lit space beneath the living room.

You can see Mirror here.

>go mirror
You walk through the mirror into a room exactly like the one you just left, but something definitely  feels different.

Elle's grip on your hand tightens. "Can we go back up now please?" she asks.

>up
Elle lets go of your hand and sits down on the couch. "Well that was anticlimactic," she says. "I thought maybe something cool would happen after going down there. Oh well, I'm thirsty. Can you get me a drink? Maybe some of that root beer I love so much?"

Living Room
The Kitchen is west. The Bedroom is east.

You can see Hidden Door, Couch (on which is Elle), Front Door and Mail here.

>donw
That's not a verb I recognise.

>down
Basement
A small and poorly lit space beneath the living room.

You can see Hidden Door and Mirror here.

>go mirror
You walk through the mirror into a room exactly like the one you just left, but something definitely  feels different.

>up
Living Room
The Bedroom is west. The Kitchen is east. The Front Door is north. There is a hidden door in the floor.

You can see Front Door, Mail, Rug, Suitcase (empty) and Couch here.

>e
Kitchen
The Living Room is west.

You can see Table and Refrigerator (closed) here.

>open fridge
You open Refrigerator, revealing Root Beer and Pineapple Juice.

>take root beer
You don't feel thirsty right now.

>go mirror
You can't see any such thing.

>down
You can't go that way.

>e
You can't go that way.

>w
Living Room
The Bedroom is west. The Kitchen is east. The Front Door is north. There is a hidden door in the floor.

You can see Front Door, Mail, Rug, Suitcase (empty) and Couch here.

>down
Basement
A small and poorly lit space beneath the living room.

You can see Mirror here.

>go mirror
You walk through the mirror into a room exactly like the one you just left, but something definitely  feels different.

>go mirror
You walk through the mirror into a room exactly like the one you just left, but something definitely  feels different.

* * *

>up
Living Room
The Bedroom is west. The Kitchen is east. The Front Door is north. There is a hidden door in the floor.

You can see Front Door, Mail, Rug, Suitcase (empty) and Couch here.

>e
Kitchen
The Living Room is west.

You can see Table and Refrigerator (in which are Root Beer and Pineapple Juice) here.

>take root beer
You don't feel thirsty right now.

>w
Living Room
The Bedroom is west. The Kitchen is east. The Front Door is north. There is a hidden door in the floor.

You can see Front Door, Mail, Rug, Suitcase (empty) and Couch here.

* * *

>go mirror
You walk through the mirror into a room exactly like the one you just left, but something definitely  feels different.

>up
"Hey did you bring me my root beer?" asks Elle.

Living Room
The Kitchen is west. The Bedroom is east.

You can see Hidden Door, Couch (on which is Elle), Front Door and Mail here.

>w
Kitchen
The Living Room is east.

You can see Table and Refrigerator (closed) here.

>open fridge
You open Refrigerator, revealing Root Beer and Pineapple Juice.

>take root beer
Suddenly you see Elle walk into the kitchen.

>give root beer to elle
Elle takes the Pineapple Juice instead and says, "C'mon, you know I hate root beer.

>e
"Hey did you bring me my root beer?" asks Elle.

Living Room
The Kitchen is west. The Bedroom is east.

You can see Hidden Door, Couch (on which is Elle), Front Door and Mail here.

>give elle root beer
"Thanks! I don't know why but root beer is my favorite," says Elle.

>take mail
Elle sees you picking up the letter and notices that it looks different. "Wait what?" Elle exclaimed, looking at it more closely. "This isn't what I brought in earlier? And I was just with Sarah the other day! Help me figure out what's going on here. Let me know if you discover anything else that seems out of place until we can figure this out."

>e
Bedroom
The Living Room is west.

You can see Bed, Dresser (empty), Clock and Calendar here.

* * *

>take calender
You can't see any such thing.

* * *

>e
You can't go that way.

>w
"Hey did you bring me my root beer?" asks Elle.

Living Room
The Kitchen is west. The Bedroom is east.

You can see Hidden Door, Couch (on which is Elle) and Front Door here.

>give elle calendar
"Wait February 30? That doesn't make sense even with a leap year!" exclaims Elle. "This doesn't make any sense. Let me know if you discover anything else that seems out of place until we can figure this out."

>give elle clock
"What is up with this clock? This doesn't even make sense by 24 hour standards," says Elle with a suspicious look on her face. Let me know if you discover anything else that seems out of place until we can figure this out.

"The mirror!" exclaims Elle. "Things started getting weird after we went down into the basement. It sounds crazy but that must be it!" 
Elle suddenly freezes. Her shocked expression locked on something behind you. You turn and suddenly see- Elle! in the kitchen glaring at both of you. Her stare is piercing, her teeth gritted, her stance wide. Your eyes only shift from her haunting expression to notice the large kitchen knife she's holding in her hand.

"It's- Me?!" the Elle next to you shrieks. She turns and looks at you, "I can see why you were probably so confused earlier," she says. 

"I don't know where you came from!" screamed the other Elle, "but He's staying here!" She suddenly begins slowly walking toward you, knife in hand. 

"We've got to get out of here!" pleads Elle, grabbing your arm. "C'mon!"

>down
You and Elle rush down to the basement, slamming the hidden door shut behind you. Elle's hand is holding on tightly to yours as you make it all the way down. Suddenly the hidden door is flung open as other Elle runs down the stairs. "I said you can't have him!" she screams as she rushes down with the knife.

Basement
A small and poorly lit space beneath the living room.

You can see Hidden Door, Mirror, Elle and Elle here.

>go mirror
You and Elle find yourselves in the basement alone. You look at each other and feel a sudden sense of relief. However you both freeze again when you suddenly hear the other Elle screaming, "Stop! You can't have him!"

>x mirror
You don't see your reflections, but what you do see is other Elle running toward you with the knife. Her image is getting bigger and bigger as it seemingly drawers nearer and nearer.

* * *

>e
(first getting off Bed)
You'd better get into some clean clothes before Elle gets here.

Living Room
The Bedroom is west. The Kitchen is east. The Front Door is north.

You can see Front Door, Suitcase (closed) and Couch here.

>open suitcase
You open Suitcase, revealing Clean Shirt and Clean Pants.

* * *

>open door
(Front Door)
You open the front door and see Elle standing there. 

"Hey you, got your mail. There's an party invitation from Sarah." she says, smiling before walking in and looking around. "Not the nicest place in the world," she remarks, "but I'm glad you finally found one-Ah!"

 She suddenly trips on a rug and drops the mail in her hand. Huh, didn't even notice that there on the floor. You rush over and help her up. "Sorry about that," she laughs. "We should probably do something about the rug though. If not, knowing me, this'll definitely happen again."

>x rug
A hidden door under the rug? Cliche much.

>e
Kitchen
The Living Room is west.

You can see Table (on which is Old Key) and Refrigerator (closed) here.

* * *

>w
Living Room
The Bedroom is west. The Kitchen is east. The Front Door is north. There is a hidden door in the floor.

You can see Front Door, Mail, Elle, Rug, Suitcase (empty) and Couch here.

>unlock hidden door with key
You unlock Hidden Door.

>down
(first opening Hidden Door)

Elle grabs your hand and slowly follows you. "This is kind of creepy," she says.

Basement
A small and poorly lit space beneath the living room.

You can see Elle and Mirror here.

>go mirror
You walk through the mirror into a room exactly like the one you just left, but something definitely  feels different.

Elle's grip on your hand tightens. "Can we go back up now please?" she asks.

* * *

>up
Elle lets go of your hand and sits down on the couch. "Well that was anticlimactic," she says. "I thought maybe something cool would happen after going down there. Oh well, I'm thirsty. Can you get me a drink? Maybe some of that root beer I love so much?"

Living Room
The Kitchen is west. The Bedroom is east.

You can see Hidden Door, Couch (on which is Elle), Front Door and Mail here.

>take mail
Elle sees you picking up the letter and notices that it looks different. "Wait what?" Elle exclaimed, looking at it more closely. "This isn't what I brought in earlier? And I was just with Sarah the other day! Help me figure out what's going on here. Let me know if you discover anything else that seems out of place until we can figure this out."

* * *

>w
"Hey did you bring me my root beer?" asks Elle.

Living Room
The Kitchen is west. The Bedroom is east.

You can see Hidden Door, Couch (on which is Elle) and Front Door here.

>give elle clock
"What is up with this clock? This doesn't even make sense by 24 hour standards," says Elle with a suspicious look on her face. Let me know if you discover anything else that seems out of place until we can figure this out.

>give elle calendar
"Wait February 30? That doesn't make sense even with a leap year!" exclaims Elle. "This doesn't make any sense. Let me know if you discover anything else that seems out of place until we can figure this out."

"The mirror!" exclaims Elle. "Things started getting weird after we went down into the basement. It sounds crazy but that must be it!" 
Elle suddenly freezes. Her shocked expression locked on something behind you. You turn and suddenly see- Elle! in the kitchen glaring at both of you. Her stare is piercing, her teeth gritted, her stance wide. Your eyes only shift from her haunting expression to notice the large kitchen knife she's holding in her hand.

"It's- Me?!" the Elle next to you shrieks. She turns and looks at you, "I can see why you were probably so confused earlier," she says. 

"I don't know where you came from!" screamed the other Elle, "but He's staying here!" She suddenly begins slowly walking toward you, knife in hand. 

"We've got to get out of here!" pleads Elle, grabbing your arm. "C'mon!"

>go front door
(first opening Front Door)
"You're kind of tired and don't feel like going outside.

* * *

>look
Bedroom (on Bed)
The Living Room is east.

You can see Dresser (closed), Clock and Calender here.

>get off bed
You'd better get into some clean clothes before Elle gets here.

>look
Bedroom
The Living Room is east.

You can see Bed, Dresser (closed), Clock and Calender here.

* * *

>gonear basement
Basement
A small and poorly lit space beneath the living room.

You can see Mirror here.

>go mirror
You walk through the mirror into a room exactly like the one you just left, but something definately feels different.

Elle's grip on your hand tightens. "Can we go back up now please?" she asks.

>up
Elle lets go of your hand and sits down on the couch. "Well that was anticlimactic," she says. "I thought maybe something cool would happen after going down there. Oh well, I'm thristy. Can you get me a drink? Maybe some of that root beer I love so much?"

Living Room
The Kitchen is west. The Bedroom is east.

You can see Hidden Door, Couch (on which is Elle), Front Door and Mail here.

>go mirror
You can't see any such thing.

* * *

>up
Elle lets go of your hand and sits down on the couch. "Well that was anticlimactic," she says. "I thought maybe something cool would happen after going down there. Oh well, I'm thristy. Can you get me a drink? Maybe some of that root beer I love so much?"

Living Room
The Kitchen is west. The Bedroom is east.

You can see Hidden Door, Couch (on which is Elle), Front Door and Mail here.

>w
You can't go that way.

>e
You walk through the mirror into a room exactly like the one you just left, but something definately feels different.

I beg your pardon?

>e
You can't go that way.

>take clock
You can't see any such thing.

>take calendar
You can't see any such thing.

>e
You can't go that way.

>w
You walk through the mirror into a room exactly like the one you just left, but something definately feels different.

Elle grabs your hand and slowly follows you. "This is kind of creepy," she says.

>give elle mail
You can't see any such thing.

>give elle clock
You can't see any such thing.

>give elle calendar
You can't see any such thing.

>w
You can't go that way.

>undo
Basement
[Previous turn undone.]

>w
You can't go that way.

* * *

>undo
Basement
[Previous turn undone.]

>down
You can't go that way.

>mirror
That's not a verb I recognise.

* * *

>up
You can't go that way.

>unlock hidden door with key
You can't see any such thing.

>x mirror
You see a full body mirror on the wall, but something is not right. You don't see your reflection, only the rest of the room around you. Odd- looks as if you could walk right through it.

* * *

>up
Elle lets go of your hand and sits down on the couch. "Well that was anticlimactic," she says. "I thought maybe something cool would happen after going down there. Oh well, I'm thristy. Can you get me a drink? Maybe some of that root beer I love so much?"

Living Room
The Kitchen is west. The Bedroom is east.

You can see Hidden Door, Couch (on which is Elle), Front Door and Mail here.

>purloin clock
Please give one of the answers above.

Would you like to RESTART, RESTORE a saved game, QUIT or UNDO the last command?

>w
Please give one of the answers above.

Would you like to RESTART, RESTORE a saved game, QUIT or UNDO the last command?

>w
Please give one of the answers above.

Would you like to RESTART, RESTORE a saved game, QUIT or UNDO the last command?

>e
Please give one of the answers above.

Would you like to RESTART, RESTORE a saved game, QUIT or UNDO the last command?

>e
Please give one of the answers above.

Would you like to RESTART, RESTORE a saved game, QUIT or UNDO the last command?

>take clock
Please give one of the answers above.

Would you like to RESTART, RESTORE a saved game, QUIT or UNDO the last command?

>take calendar
Please give one of the answers above.

Would you like to RESTART, RESTORE a saved game, QUIT or UNDO the last command?

>e
Please give one of the answers above.

Would you like to RESTART, RESTORE a saved game, QUIT or UNDO the last command?

>w
Please give one of the answers above.

Would you like to RESTART, RESTORE a saved game, QUIT or UNDO the last command?

>take mail
Please give one of the answers above.

Would you like to RESTART, RESTORE a saved game, QUIT or UNDO the last command?

>give mail to elle
Please give one of the answers above.

Would you like to RESTART, RESTORE a saved game, QUIT or UNDO the last command?

>give clock to elle
Please give one of the answers above.

Would you like to RESTART, RESTORE a saved game, QUIT or UNDO the last command?

>give calendar to elle
Please give one of the answers above.

Would you like to RESTART, RESTORE a saved game, QUIT or UNDO the last command?

>w
Please give one of the answers above.

Would you like to RESTART, RESTORE a saved game, QUIT or UNDO the last command?

* * *

>up
Elle lets go of your hand and sits down on the couch. "Well that was anticlimactic," she says. "I thought maybe something cool would happen after going down there. Oh well, I'm thristy. Can you get me a drink? Maybe some of that root beer I love so much?"

Living Room
The Kitchen is west. The Bedroom is east.

You can see Hidden Door, Couch (on which is Elle), Front Door and Mail here.

>puloin mail
That's not a verb I recognise.

>purloin mail
(Mail)
[Purloined.]

>purloin clock
Which do you mean, Clock or Clock?

>purloin clock1
[Purloined.]

>purloin calender1
Which do you mean, Calender or Calender?

>calender1
Which do you mean, Calender or Calender?

>calender
Which do you mean, Calender or Calender?

I beg your pardon?

>w
I only understood you as far as wanting to purloin west.

>e
Bedroom
The Living Room is west.

You can see Bed, Dresser (empty) and Calender here.

>take calender
Taken.

>i
You are carrying:
  Calender
  Clock
  Mail
  Dirty Pants (being worn)
  Dirty Shirt (being worn)
  Old Key

>e
You can't go that way.

>w
Living Room
The Kitchen is west. The Bedroom is east.

You can see Hidden Door, Couch (on which is Elle) and Front Door here.

>give ell mail
You can't see any such thing.

>give elle mail
"Wait what?" Elle exclaimed. "This isn't what I brought in earlier? And I was just with Sarah the other day! Help me figure out what's going on here. Let me know if you discover anything!"

>give clock elle
You can only do that to something animate.

>give calender elle
You can only do that to something animate.

>give elle calender
"Wait February 30? That doesn't make sense even with a leap year!" exclaims Elle. "This doesn't make any sense."

>give elle clock
"What is up with this clock? This doesn't even make sense by 24 hour standards," says Elle with a suspicious look on her face.

"The mirror!" exclaims Elle. "Things started getting weird after we went down into the basement. It sounds crazy but that must be it!" 
Elle suddenly freezes. Her shocked expression locked on something behind you. You turn and suddenly see- Elle! in the kitchen glaring at both of you. Her stare is piercing, her teeth gritted, her stance wide. Your eyes only shift from her haunting expression to notice the large kitchen knife she's holding in her hand.

"It's- Me?!" the Elle next to you shrieks. She turns and looks at you, "I can see why you were probably so confused earlier," she says. 

"I don't know where you came from!" screamed the other Elle, "but He's staying here!" She suddenly begins slowly walking toward you, knife in hand. 

"We've got to get out of here!" pleads Elle, grabbing your arm. "C'mon!"

>down
You and Elle rush down to the basement, slaming the hidden door shut behind you. Elle's hand is holding on tightly to yours as you make it all the way down. Suddenly the hidden door is flung open as other Elle runs down the stairs. "I said you can't have him!" she screams as she rushes down with the knife.

Basement
A small and poorly lit space beneath the living room.

You can see Elle, Elle, Hidden Door and Mirror here.

>x elle
Who do you mean, Elle or Elle?

>enter mirror
You and Elle find yourselves in the basement alone. You look at each other and feel a sudden sense of relief. However you both freeze again when you suddenly hear the other Elle screaming, "Stop! You can't have him!"

You walk through the mirror into a room exactly like the one you just left, but something definately feels different.

Elle grabs your hand and slowly follows you. "This is kind of creepy," she says.

>undo
Basement
[Previous turn undone.]

>enter mirror
You and Elle find yourselves in the basement alone. You look at each other and feel a sudden sense of relief. However you both freeze again when you suddenly hear the other Elle screaming, "Stop! You can't have him!"

You walk through the mirror into a room exactly like the one you just left, but something definately feels different.

Elle grabs your hand and slowly follows you. "This is kind of creepy," she says.

>x mirror
You don't see your reflections, but what you do see is other Elle running toward you with the knife. Her image is getting bigger and bigger as it seemingly drawers nearer and nearer.

>up
You can't go that way.

>break mirror
Violence isn't the answer to this one.

>yes it is
I only understood you as far as wanting to yes.

>purloin other dimension
[Purloined.]

>i
You are carrying:
  Other Dimension
    You
    Escape
  Dirty Pants (being worn)
  Dirty Shirt (being worn)
  Old Key

* * *

>up
Elle lets go of your hand and sits down on the couch. "Well that was anticlimactic," she says. "I thought maybe something cool would happen after going down there. Oh well, I'm thristy. Can you get me a drink? Maybe some of that root beer I love so much?"

Living Room
The Kitchen is west. The Bedroom is east.

You can see Hidden Door, Couch (on which is Elle), Front Door and Mail here.

>take mail
Elle sees you picking up the letter and notices that it looks different. "Wait what?" Elle exclaimed, looking at it more closely. "This isn't what I brought in earlier? And I was just with Sarah the other day! Help me figure out what's going on here. Let me know if you discover anything else that seems out of place until we can figure this out."

>w
Kitchen
The Living Room is east.

You can see Table and Refrigerator (closed) here.

>e
"Hey did you bring me my root beer?" asks Elle.

Living Room
The Kitchen is west. The Bedroom is east.

You can see Hidden Door, Couch (on which is Elle) and Front Door here.

>e
Bedroom
The Living Room is west.

You can see Bed, Dresser (empty), Clock and Calendar here.

* * *

>e
You can't go that way.

>e
You can't go that way.

* * *

>w
"Hey did you bring me my root beer?" asks Elle.

Living Room
The Kitchen is west. The Bedroom is east.

You can see Hidden Door, Couch (on which is Elle) and Front Door here.

>give clock to elel
You can't see any such thing.

>give clock to elle
"What is up with this clock? This doesn't even make sense by 24 hour standards," says Elle with a suspicious look on her face. Let me know if you discover anything else that seems out of place until we can figure this out.

>give calendar to elle
"Wait February 30? That doesn't make sense even with a leap year!" exclaims Elle. "This doesn't make any sense. Let me know if you discover anything else that seems out of place until we can figure this out."

"The mirror!" exclaims Elle. "Things started getting weird after we went down into the basement. It sounds crazy but that must be it!" 
Elle suddenly freezes. Her shocked expression locked on something behind you. You turn and suddenly see- Elle! in the kitchen glaring at both of you. Her stare is piercing, her teeth gritted, her stance wide. Your eyes only shift from her haunting expression to notice the large kitchen knife she's holding in her hand.

"It's- Me?!" the Elle next to you shrieks. She turns and looks at you, "I can see why you were probably so confused earlier," she says. 

"I don't know where you came from!" screamed the other Elle, "but He's staying here!" She suddenly begins slowly walking toward you, knife in hand. 

"We've got to get out of here!" pleads Elle, grabbing your arm. "C'mon!"

>down
You and Elle rush down to the basement, slaming the hidden door shut behind you. Elle's hand is holding on tightly to yours as you make it all the way down. Suddenly the hidden door is flung open as other Elle runs down the stairs. "I said you can't have him!" she screams as she rushes down with the knife.

Basement
A small and poorly lit space beneath the living room.

You can see Hidden Door, Mirror, Elle and Elle here.

>go mirror
You and Elle find yourselves in the basement alone. You look at each other and feel a sudden sense of relief. However you both freeze again when you suddenly hear the other Elle screaming, "Stop! You can't have him!"

* * *

>x mirror
You don't see your reflections, but what you do see is other Elle running toward you with the knife. Her image is getting bigger and bigger as it seemingly drawers nearer and nearer.

>break mirror
Violence isn't the answer to this one.

>punch mirror
Violence isn't the answer to this one.

>breaking mirror
That's not a verb I recognise.

>break mirror
Violence isn't the answer to this one.

* * *

>punch mirror
Violence isn't the answer to this one.

>purloin escape
[Purloined.]

>i
You are carrying:
  Escape
  Dirty Pants (being worn)
  Dirty Shirt (being worn)

* * *

>go mirror
You walk through the mirror into a room exactly like the one you just left, but something definately feels different.

Elle's grip on your hand tightens. "Can we go back up now please?" she asks.

>go up
Elle lets go of your hand and sits down on the couch. "Well that was anticlimactic," she says. "I thought maybe something cool would happen after going down there. Oh well, I'm thristy. Can you get me a drink? Maybe some of that root beer I love so much?"

Living Room
The Kitchen is west. The Bedroom is east.

You can see Hidden Door, Couch (on which is Elle), Front Door and Mail here.

>w
Kitchen
The Living Room is east.

You can see Table and Refrigerator (closed) here.

>e
"Hey did you bring me my root beer?" asks Elle.

Living Room
The Kitchen is west. The Bedroom is east.

You can see Hidden Door, Couch (on which is Elle), Front Door and Mail here.

>take mail
Elle sees you picking up the letter and notices that it looks different. "Wait what?" Elle exclaimed, looking at it more closely. "This isn't what I brought in earlier? And I was just with Sarah the other day! Help me figure out what's going on here. Let me know if you discover anything else that seems out of place until we can figure this out."

* * *

>down
You and Elle rush down to the basement, slaming the hidden door shut behind you. Elle's hand is holding on tightly to yours as you make it all the way down. Suddenly the hidden door is flung open as other Elle runs down the stairs. "I said you can't have him!" she screams as she rushes down with the knife.

Basement
A small and poorly lit space beneath the living room.

You can see Hidden Door, Mirror, Elle and Elle here.

* * *

>w
(first getting off Bed)
You'd better get into some clean clothes before Elle gets here.

You can't go that way.

>e
Living Room
The Bedroom is west. The Kitchen is east. The Front Door is north.

You can see Front Door, Suitcase (closed) and Couch here.

>e
Kitchen
The Living Room is west.

You can see Table (on which is Old Key) and Refrigerator (closed) here.

>take old key
Taken.

>w
Living Room
The Bedroom is west. The Kitchen is east. The Front Door is north.

You can see Front Door, Suitcase (closed) and Couch here.

>open suitcase
You open Suitcase, revealing Clean Shirt and Clean Pants.

>take off clean shirt
(first taking Clean Shirt)
You're not wearing that.

>take off dirty shirt
You take off Dirty Shirt.

>take off dirty pants
Well now you're not wearing any clothes! Get dressed!

* * *

>x clock
5:00 PM

>x calender
March 8, 2013

>x dresser
A small dresser in your bedroom. It has one drawer.

>open drawer
You haven't unpacked your things yet. Your clothes must be in your suitcase somewhere.

>look
Bedroom (on Bed)
The Living Room is east.

You can see Dresser (closed), Clock and Calender here.

>east
(first getting off Bed)
You'd better get into some clean clothes before Elle gets here.

Living Room
The Bedroom is west. The Kitchen is east. The Front Door is north.

You can see Front Door, Suitcase (closed) and Couch here.

>x couch
A white cloth couch in the middle of the living room.

>west
Bedroom
The Living Room is east.

You can see Bed, Dresser (closed), Clock and Calender here.

>east
Living Room
The Bedroom is west. The Kitchen is east. The Front Door is north.

You can see Front Door, Suitcase (closed) and Couch here.

>x suitcase
The biggest suitcase you own filled with everything you could fit inside.

>take suitcase
Taken.

>west
Bedroom
The Living Room is east.

You can see Bed, Dresser (closed), Clock and Calender here.

>open suitcase
You open Suitcase, revealing Clean Shirt and Clean Pants.

>remove clothes
You can't see any such thing.

>take off clothes
You can't see any such thing.

>put on clean shirt
(first taking Clean Shirt)

* * *

>put on clean pants
(first taking Clean Pants)

You hear the doorbell ring.

>x self
 You are wearing a dirty shirt.  You are wearing dirty pants.  You are wearing a clean shirt.  You are wearing clean pants.

You hear the doorbell ring.

>take off clean shirt
You take off Clean Shirt.

* * *

>take off clean pants
You take off Clean Pants.

>take off dirty shirt
You take off Dirty Shirt.

>take off dirty pants
You take off Dirty Pants.

* * *

>put on clean shirt
You're already wearing that!

>put on clean pants
You hear the doorbell ring.

>look
Bedroom
The Living Room is east.

You can see Bed, Dresser (closed), Clock and Calender here.

You hear the doorbell ring.

>east
Living Room
The Bedroom is west. The Kitchen is east. The Front Door is north.

You can see Front Door and Couch here.

You hear the doorbell ring.

>open front door
You open the front door and see Elle standing there. 

"Hey you, got your mail. There's an party invitation from Sarah." she says, smiling before walking in and looking around. "Not the nicest place in the world," she remarks, "but I'm glad you finally found one-Ah!"

 She suddenly trips on a rug and drops the mail in her hand. You rush over and help her up. "Sorry about that," she laughs. "We should probably do something about the rug though. If not, knowing me, this'll definately happen again."

>x rug
A hidden door under the rug? Cliche much.

>open hidden door
It seems to be locked.

>x elle
Your girlfriend Elle. She's kind of crazy but you love her.

>kitchen
That's not a verb I recognise.

>east
Kitchen
The Living Room is west.

You can see Table and Refrigerator (closed) here.

>x table
You see nothing special about Table.

>x refigerator
You can't see any such thing.

>refrigerator
That's not a verb I recognise.

>x fridge
You see nothing special about Refrigerator.

>i
You are carrying:
  Clean Pants (being worn)
  Clean Shirt (being worn)
  Suitcase (open but empty)
  Dirty Pants
  Dirty Shirt
  Old Key

>x key
An old key that was given too you when you bought the house. It isn't for any of the doors though.

>open fridge
You open Refrigerator, revealing Root Beer and Pineapple Juice.

* * *

>take root beer
You don't feel thirsty right now.

>take pineapple juice
You don't feel thirsty right now.

>look
Kitchen
The Living Room is west.

You can see Table and Refrigerator (in which are Root Beer and Pineapple Juice) here.

>west
Living Room
The Bedroom is west. The Kitchen is east. The Front Door is north.

You can see Front Door, Mail, Elle, Rug and Couch here.

>x rug
There is a rug on the floor in the living room. You don't know why but this rug seems really out of place.

>look under rug
You find nothing of interest.

>x hidden door
It's a hidden door made from the wood of the floor boards. It was covered by the rug.

>unlock door
What do you want to unlock Front Door with?

>unlock door with old key
(Front Door with Old Key)
That doesn't seem to be something you can unlock.

>unlock hidden door with old key
You unlock Hidden Door.

>open hidden door
You open Hidden Door.

>x hidden door
It's a hidden door made from the wood of the floor boards. It was covered by the rug.

>enter hidden door
Elle grabs your hand and slowly follows you. "This is kind of creepy," she says.

Basement
A small and poorly lit space beneath the living room.

You can see Elle and Mirror here.

>x mirror
You see a full body mirror on the wall, but something is not right. You don't see your reflection, only the rest of the room around you. Odd- looks as if you could walk right through it.

>touch mirror
You feel nothing unexpected.

>enter mirror
You walk through the mirror into a room exactly like the one you just left, but something definately feels different.

>x room
You can't see any such thing.

>look
Basement
A small and poorly lit space beneath the living room.

You can see Elle, Hidden Door and Mirror here.

>x elle
Your girlfriend Elle. She's kind of crazy but you love her.

>x mirror
You see a full body mirror on the wall, but something is not right. You don't see your reflection, only the rest of the room around you. Odd- looks as if you could walk right through it.

>enter hidden door
I only understood you as far as wanting to enter Hidden Door.

>exit basement
I only understood you as far as wanting to exit.

>exit hidden door
I only understood you as far as wanting to exit.

>climb out hidden door
I only understood you as far as wanting to climb outside.

>go hidden door
You can't see any such thing.

>up
Elle lets go of your hand and sits down on the couch. "Well that was anticlimactic," she says. "I thought maybe something cool would happen after going down there. Oh well, I'm thristy. Can you get me a drink? Maybe some of that root beer I love so much?"

Living Room
The Kitchen is west. The Bedroom is east.

You can see Hidden Door, Couch (on which is Elle), Front Door and Mail here.

>west
Kitchen
The Living Room is east.

You can see Table and Refrigerator (closed) here.

>open fridge
You open Refrigerator, revealing Root Beer and Pineapple Juice.

>x root beer
Barq's delicious root beer.

>take root beer
Suddenly you see Elle walk into the kitchen.

>give root beer to elle
Elle takes the Pineapple Juice and says, "C'mon, you know I hate root beer. Oh could you also bring me the mail?"

>east
"Hey did you bring me my root beer?" asks Elle.

Living Room
The Kitchen is west. The Bedroom is east.

You can see Hidden Door, Couch (on which is Elle), Front Door and Mail here.

>x mail
It's a letter to attend Sarah Martin's funeral next weekend.

>give root beer to elle
"Thanks! I don't know why but root beer is my favorite," says Elle.

>take mail
Taken.

>west
Kitchen
The Living Room is east.

You can see Elle, Table and Refrigerator (empty) here.

>x elle
Your girlfriend Elle. She's kind of crazy but you love her.

>give mail to elle
Elle doesn't seem interested.

>open fridge
That's already open.

>x fridge
Refrigerator is empty.

>east
"Hey did you bring me my root beer?" asks Elle.

Living Room
The Kitchen is west. The Bedroom is east.

You can see Hidden Door, Couch (on which is Elle) and Front Door here.

>give elle mail
"Wait what?" Elle exclaimed. "This isn't what I brought in earlier? And I was just with Sarah the other day! Help me figure out what's going on here. Let me know if you discover anything!"

>east
Bedroom
The Living Room is west.

You can see Bed, Dresser (empty), Clock and Calender here.

>x clock
13:27 AM

>x calender
February 30, 2013.

>x bed
You see nothing special about Bed.

>x dresser
Dresser is empty.

>take clock
Taken.

>west
"Hey did you bring me my root beer?" asks Elle.

Living Room
The Kitchen is west. The Bedroom is east.

You can see Hidden Door, Couch (on which is Elle) and Front Door here.

>give clock to elle
"What is up with this clock? This doesn't even make sense by 24 hour standards," says Elle with a suspicious look on her face.

>i
You are carrying:
  Clean Pants (being worn)
  Clean Shirt (being worn)
  Suitcase (open but empty)
  Dirty Pants
  Dirty Shirt
  Old Key

>east
Bedroom
The Living Room is west.

You can see Bed, Dresser (empty) and Calender here.

>take calender
Taken.

>west
"Hey did you bring me my root beer?" asks Elle.

Living Room
The Kitchen is west. The Bedroom is east.

You can see Hidden Door, Couch (on which is Elle) and Front Door here.

>give calender to elle
"Wait February 30? That doesn't make sense even with a leap year!" exclaims Elle. "This doesn't make any sense."

"The mirror!" exclaims Elle. "Things started getting weird after we went down into the basement. It sounds crazy but that must be it!" 
Elle suddenly freezes. Her shocked expression locked on something behind you. You turn and suddenly see- Elle! in the kitchen glaring at both of you. Her stare is piercing, her teeth gritted, her stance wide. Your eyes only shift from her haunting expression to notice the large kitchen knife she's holding in her hand.

"It's- Me?!" the Elle next to you shrieks. She turns and looks at you, "I can see why you were probably so confused earlier," she says. 

"I don't know where you came from!" screamed the other Elle, "but He's staying here!" She suddenly begins slowly walking toward you, knife in hand. 

"We've got to get out of here!" pleads Elle, grabbing your arm. "C'mon!"

>look
Living Room
The Kitchen is west. The Bedroom is east.

You can see Hidden Door, Couch (on which is Elle) and Front Door here.

>enter hidden door
I only understood you as far as wanting to enter Hidden Door.

>down
You and Elle rush down to the basement, slaming the hidden door shut behind you. Elle's hand is holding on tightly to yours as you make it all the way down. Suddenly the hidden door is flung open as other Elle runs down the stairs. "I said you can't have him!" she screams as she rushes down with the knife.

Basement
A small and poorly lit space beneath the living room.

You can see Elle, Elle, Hidden Door and Mirror here.

>enter mirror
You and Elle find yourselves in the basement alone. You look at each other and feel a sudden sense of relief. However you both freeze again when you suddenly hear the other Elle screaming, "Stop! You can't have him!"

You walk through the mirror into a room exactly like the one you just left, but something definately feels different.

>look
Basement
A small and poorly lit space beneath the living room.

You can see Mirror and Elle here.

>x mirror
You don't see your reflections, but what you do see is other Elle running toward you with the knife. Her image is getting bigger and bigger as it seemingly drawers nearer and nearer.

>purloin other dimensino
There seems to be no such object anywhere in the model world.

>purloin other dimension
[Purloined.]

>i
You are carrying:
  Other Dimension
    You
    Escape
  Clean Pants (being worn)
  Clean Shirt (being worn)
  Suitcase (open but empty)
  Dirty Pants
  Dirty Shirt
  Old Key

>undo
Basement
[Previous turn undone.]

>undo
Basement
[Previous turn undone.]

>undo
"Undo" failed.  [Not all interpreters provide it.]

>look
Basement
A small and poorly lit space beneath the living room.

You can see Mirror and Elle here.