Bedroom (on Bed)
The Living Room is east.

You can see Dresser (closed), Clock and Calender here.

You've just arrived at your new house a couple of hours ago but instantly crashed on your new bed when you got there. You just woke up from your nap and realized it's already 5:00 pm. Your girlfriend Ellie was going to come over to see the new place. You'd better start actually looking around now. It's a little run down but hey, what did you expect from craigslist. Too bad you can't afford a nicer place yet.

Inform Final Project
An Interactive Fiction by Nolan Chung
Release 1 / Serial number 130316 / Inform 7 build 6G60 (I6/v6.32 lib 6/12N) SD

Bedroom (on Bed)
The Living Room is east.

You can see Dresser (closed), Clock and Calender here.

>purloin real
[Purloined.]

>purlion dimension
That's not a verb I recognise.

>purloin dimension
[Purloined.]

>i
You are carrying:
  Other Dimension
  Real World
    You
  Dirty Pants (being worn)
  Dirty Shirt (being worn)

>e
(first getting off Bed)
You'd better get into some clean clothes before Ellie gets here.

Living Room
The Bedroom is west. The Kitchen is east. The Front Door is north.

You can see Suitcase (closed), Front Door, Rug and Couch here.

>take off dirty pants
You take off Dirty Pants.

>take off dirty shirt
You take off Dirty Shirt.

>put on clean shirt
You can't see any such thing.

>open suitcase
You open Suitcase, revealing Clean Shirt and Clean Pants.

* * *

>put on clean shirt
(first taking Clean Shirt)

>put on clean pants
(first taking Clean Pants)

 You hear the doorbell ring.

>open door
(Front Door)
You open the front door and see Elle standing there. 

"Hey you, got your mail," she says, smiling before walking in and looking around. "Not the nicest place in the world," she remarks, "but I'm glad you finally found one-Ah!"

 She suddenly trips on the rug and drops the mail in her hand. You rush over and help her up. "Sorry about that," she laughs. "We should probably do something about the rug though. If not knowing me this'll definately happen again."

>x rug
A hidden door under the rug? Cliche much.

>open hidden door
You open Hidden Door.

>down
Elle grabs your hand and slowly follows you. "This is kind of creepy," she says.

Basement
You can see Elle and Mirror here.

>i
You are carrying:
  Clean Pants (being worn)
  Clean Shirt (being worn)
  Other Dimension
  Real World
    You
  Dirty Pants
  Dirty Shirt

>go mirror
Odd Everything seems to be the same. But something definately feels different.

>i
You are carrying:
  Clean Pants (being worn)
  Clean Shirt (being worn)
  Other Dimension
  Real World
    You
  Dirty Pants
  Dirty Shirt

* * *

>go mirror
Odd Everything seems to be the same. But something definately feels different.

>i
You are carrying:
  Clean Pants (being worn)
  Clean Shirt (being worn)
  Other Dimension
    You
  Real World
  Dirty Pants
  Dirty Shirt

>go mirror
Odd Everything seems to be the same. But something definately feels different.

* * *

>purloin real
[Purloined.]

>purloin dimension
[Purloined.]

>x real
In Real World is You.

>x dimension
Other Dimension is empty.

>e
(first getting off Bed)
You'd better get into some clean clothes before Ellie gets here.

Living Room
The Bedroom is west. The Kitchen is east. The Front Door is north.

You can see Suitcase (closed), Front Door, Rug and Couch here.

>take off dirty
Which do you mean, Dirty Pants or Dirty Shirt?

>both
Sorry, you can only have one item here. Which exactly?

>all
Sorry, you can only have one item here. Which exactly?

>take off dirty shirt
You take off Dirty Shirt.

* * *

>take off dirty pants
You take off Dirty Pants.

>put on clean shirt
You can't see any such thing.

>put on clean pants
You can't see any such thing.

>open suitcase
You open Suitcase, revealing Clean Shirt and Clean Pants.

* * *

>put on clean shirt
(first taking Clean Shirt)

>wear clean pants
(first taking Clean Pants)

 You hear the doorbell ring.

>open door
(Front Door)
You open the front door and see Elle standing there. 

"Hey you, got your mail," she says, smiling before walking in and looking around. "Not the nicest place in the world," she remarks, "but I'm glad you finally found one-Ah!"

 She suddenly trips on the rug and drops the mail in her hand. You rush over and help her up. "Sorry about that," she laughs. "We should probably do something about the rug though. If not knowing me this'll definately happen again."

* * *

>down
Elle grabs your hand and slowly follows you. "This is kind of creepy," she says.

Basement
You can see Elle and Mirror here.

>go mirror
Odd Everything seems to be the same. But something definately feels different.

>x dimension
Other Dimension is empty.

>x real
In Real World is You.

* * *

>purloin real
[Purloined.]

>purloin other
(Real World)
[Purloined.]

>purloin dimension
[Purloined.]

* * *

>x real
In Real World is You.

>x dimensino
You can't see any such thing.

>x dimension
Other Dimension is empty.

* * *

>e
(first getting off Bed)
You'd better get into some clean clothes before Ellie gets here.

Living Room
The Bedroom is west. The Kitchen is east. The Front Door is north.

You can see Suitcase (closed), Front Door, Rug and Couch here.

>x rug
A hidden door under the rug? Cliche much.

>open suitcase
You open Suitcase, revealing Clean Shirt and Clean Pants.

>take off dirty pants
You take off Dirty Pants.

* * *

>take off dirty shirt
You take off Dirty Shirt.

>put on clean shirt
(first taking Clean Shirt)

* * *

>open door
(Front Door)
You open the front door and see Elle standing there. 

"Hey you, got your mail," she says, smiling before walking in and looking around. "Not the nicest place in the world," she remarks, "but I'm glad you finally found one-Ah!"

 She suddenly trips on the rug and drops the mail in her hand. You rush over and help her up. "Sorry about that," she laughs. "We should probably do something about the rug though. If not knowing me this'll definately happen again."

>x rug
There is a rug on the floor in the living room. You don't know why but this rug seems really out of place.

>down
(first opening Hidden Door)
Elle grabs your hand and slowly follows you. "This is kind of creepy," she says.

Basement
You can see Elle and Mirror here.

>x real
In Real World is You.

* * *

>x dimension
Other Dimension is empty.

>go mirror
Odd Everything seems to be the same. But something definately feels different.

* * *

>x dimension
Other Dimension is empty.

>x rea
You can't see any such thing.

>x real
In Real World is You.

>go mirror
Odd Everything seems to be the same. But something definately feels different.

>x dimension
In Other Dimension is You.

>x real
Real World is empty.

* * *

>take off shirt
You take off Dirty Shirt.

>take off pant
You can't see any such thing.

>take off pants
You take off Dirty Pants.

>go e
(first getting off Bed)
You'd better get into some clean clothes before Ellie gets here.

Living Room
The Bedroom is west. The Kitchen is east. The Front Door is north.

You can see Front Door, Suitcase (closed) and Couch here.

>open suitcase
You open Suitcase, revealing Clean Shirt and Clean Pants.

* * *

>put on clean pants
(first taking Clean Pants)

You hear the doorbell ring.

>close suitcase
You close Suitcase.

You hear the doorbell ring.

>open door
(Front Door)
You open the front door and see Elle standing there. 

"Hey you, got your mail," she says, smiling before walking in and looking around. "Not the nicest place in the world," she remarks, "but I'm glad you finally found one-Ah!"

 She suddenly trips on a rug and drops the mail in her hand. You rush over and help her up. "Sorry about that," she laughs. "We should probably do something about the rug though. If not, knowing me, this'll definately happen again."

>x rug
A hidden door under the rug? Cliche much.

>d
(first opening Hidden Door)
Elle grabs your hand and slowly follows you. "This is kind of creepy," she says.

Basement
You can see Elle and Mirror here.

>x mirror
You see a full body mirror on the wall, but something is not right. You don't see your reflection, only the rest of the room around you. Odd- looks as if you could walk right through it.

>go mirror
You walk through the mirror into a room exactly like the one you just left, but something definately feels different.

>up
Elle lets go of your hand and sits down on the couch. "Well that was anticlimactic," she says. "I thought maybe something cool would happen after going down there."

Living Room
You can see Hidden Door, Couch (on which is Elle), Front Door and Mail here.

>x couch
A white leather couch in the middle of the living room.

On Couch is Elle.

>x couch
A white leather couch in the middle of the living room.

On Couch is Elle.

>gonear living room
Living Room
The Bedroom is west. The Kitchen is east. The Front Door is north.

You can see Front Door, Mail, Rug, Suitcase (closed) and Couch here.

>gonear living room1
Living Room
You can see Hidden Door, Couch (on which is Elle), Front Door and Mail here.

>x couch
A white leather couch in the middle of the living room.

On Couch is Elle.

>i
You are carrying:
  Clean Pants (being worn)
  Clean Shirt (being worn)
  Dirty Pants
  Dirty Shirt

* * *

>take off clothes
You can't see any such thing.

>take off shirt
You take off Dirty Shirt.

>take off pants
You take off Dirty Pants.

>open dresser
You open the dresser drawer to reveal: nothing. And a dead spider. Boring.

>e
(first getting off Bed)
You'd better get into some clean clothes before Ellie gets here.

Living Room
The Bedroom is west. The Kitchen is east. The Front Door is north.

You can see Front Door, Suitcase (closed) and Couch here.

>open suitcase
You open Suitcase, revealing Clean Shirt and Clean Pants.

* * *

>put on clean pants
(first taking Clean Pants)

You hear the doorbell ring.

>take rug
You can't see any such thing.

* * *

>east
(first getting off Bed)
You'd better get into some clean clothes before Ellie gets here.

Living Room
The Bedroom is west. The Kitchen is east. The Front Door is north.

You can see Suitcase (closed), Front Door, Rug and Couch here.

* * *

>x self
 You are wearing a dirty shirt.  You are wearing dirty pants.

>stand up
You'd better get into some clean clothes before Ellie gets here.

>look
Bedroom
The Living Room is east.

On Dresser is Clock.

You can also see Bed and Calender here.

>x clock
5:00 PM

>x dresser
(Dresser)
A small dresser in your bedroom. There is one big dresser drawer.

On Dresser is Clock.

>open dresser drawer
You haven't unpacked your things yet. Your clothes must be in your suitcase somewhere.

>e
Living Room
The Bedroom is west. The Kitchen is east. The Front Door is north.

You can see Suitcase (closed), Front Door, Rug and Couch here.

>open suitcase
You open Suitcase, revealing Clean Shirt and Clean Pants.

>take off dirty shirt
You take off Dirty Shirt.

* * *

>take off dirty pants
You take off Dirty Pants.

>put on clean pants
(first taking Clean Pants)

>put on clean shirt
(first taking Clean Shirt)

 You hear the doorbell ring

>open door
(Front Door)
You open the front door and see Elle standing there. 

"Hey you, got your mail," she says, smiling before walking in. "Not the nicest place in the world," she remarks, "but I'm glad you finally found one-Ah!"

 She suddenly trips on the rug and drops the mail in her hand. You rush over and help her up. "Sorry about that," she laughs. "We should probably do something about the rug though. If not knowing me this'll definately happen again."

>move rug
A hidden door under the rug? Cliche much.

>x rug
A hidden door under the rug? Cliche much.

>open hiden door
You can't see any such thing.

>open hidden door
You open Hidden Door.

* * *

>x mirror
You see a full body mirror on the wall, but something is not right. You don't see your reflection, only the rest of the room around you. Odd looks as if you could walk right through it.

>x elle
You see nothing special about Elle.

>go mirror
Odd Everything seems to be the same. But something definately feels different.

>go mirror
Odd Everything seems to be the same. But something definately feels different.

>look
Basement
You can see Mirror and Hidden Door here.

* * *

>go down
Basement
You can see Hidden Door and Mirror here.

>go up
Living Room
You can see Hidden Door, Elle, Couch and Mail here.

* * *

>gonear livingroom1
There seems to be no such object anywhere in the model world.

>gonear basement
Basement
You can see Mirror here.

>go mirror
Odd Everything seems to be the same. But something definately feels different.

>look
Basement
You can see Elle, Hidden Door and Mirror here.

>go up
Elle lets go of your hand and sits down on the couch. "Well that was anticlimactic," she says. "I thought maybe something cool would happen after going down there."

Living Room
You can see Hidden Door, Couch (on which is Elle) and Mail here.

>x mail
It's a letter to attend Sarah Martin's funeral next weekend.

* * *

>e
(first getting off Bed)
You'd better get into some clean clothes before Ellie gets here.

Living Room
The Bedroom is west. The Kitchen is east. The Front Door is north.

You can see Front Door, Suitcase (closed) and Couch here.

>x couch
A white cloth couch in the middle of the living room.

>gonear living room1
Living Room
You can see Hidden Door, Couch, Front Door and Mail here.

>x couch
A white leather couch in the middle of the living room.

* * *

>open suitcase
You open Suitcase, revealing Clean Shirt and Clean Pants.

>take off dirty clothes
Which do you mean, Dirty Pants or Dirty Shirt?

>pants
You can't see any such thing.

>take off dirty shirt
You take off Dirty Shirt.

* * *

>open door
(Front Door)
You open the front door and see Elle standing there. 

"Hey you, got your mail," she says, smiling before walking in and looking around. "Not the nicest place in the world," she remarks, "but I'm glad you finally found one-Ah!"

 She suddenly trips on the rug and drops the mail in her hand. You rush over and help her up. "Sorry about that," she laughs. "We should probably do something about the rug though. If not knowing me this'll definately happen again."

>take mail
Taken.

>drop mail
Dropped.

>x rug
A hidden door under the rug? Cliche much.

* * *

>down
Elle grabs your hand and slowly follows you. "This is kind of creepy," she says.

Basement
You can see Elle and Mirror here.

>x mirro
You can't see any such thing.

>x mirror
You see a full body mirror on the wall, but something is not right. You don't see your reflection, only the rest of the room around you. Odd looks as if you could walk right through it.

>go mirror
Odd Everything seems to be the same. But something definately feels different.

* * *

>go up
Elle lets go of your hand and sits down on the couch. "Well that was anticlimactic," she says. "I thought maybe something cool would happen after going down there."

Living Room
You can see Hidden Door, Couch (on which is Elle) and Mail here.

>x real
You can't see any such thing.

>purloin real
[Purloined.]

* * *

>purloin dimension
[Purloined.]

>x dimension
Other Dimension is empty.

>x real world
In Real World is You.

>down
Basement
You can see Hidden Door and Mirror here.

>go mirror
Odd Everything seems to be the same. But something definately feels different.

* * *

>x dimension
In Other Dimension is You.

>d real
I only understood you as far as wanting to d.

* * *

>open suitcase
You open Suitcase, revealing Clean Shirt and Clean Pants.

>take off shit
You can't see any such thing.

>take off shirt
(Dirty Shirt)
You take off Dirty Shirt.

>take off pants
(Dirty Pants)
You take off Dirty Pants.

>put on clean pants
(first taking Clean Pants)

* * *

>move rug
A hidden door under the rug? Cliche much.

>x ellie
You can't see any such thing.

>open door
(Front Door)
That's not something you can open.

* * *

>purloin other dimension
[Purloined.]

>purloin real world
[Purloined.]

>x world
Real World is empty.

>x dimensin
You can't see any such thing.

>x dimension
Other Dimension is empty.

>gonear basement
Basement
You can see Mirror here.

* * *

>purloin dimension
[Purloined.]

>purloin real
[Purloined.]

>i
You are carrying:
  Real World
    You
  Other Dimension
  Dirty Pants (being worn)
  Dirty Shirt (being worn)

>take dirty shirt off
You take off Dirty Shirt.

>take dirty pants off
You take off Dirty Pants.

>put on clean shirt
You can't see any such thing.

>e
(first getting off Bed)
You'd better get into some clean clothes before Ellie gets here.

Living Room
The Bedroom is west. The Kitchen is east. The Front Door is north.

You can see Suitcase (closed), Front Door, Rug and Couch here.

>open suitcase
You open Suitcase, revealing Clean Shirt and Clean Pants.

* * *

>open door
(Front Door)
You open the front door and see Elle standing there. 

"Hey you, got your mail," she says, smiling before walking in and looking around. "Not the nicest place in the world," she remarks, "but I'm glad you finally found one-Ah!"

 She suddenly trips on the rug and drops the mail in her hand. You rush over and help her up. "Sorry about that," she laughs. "We should probably do something about the rug though. If not knowing me this'll definately happen again."

>move rug
A hidden door under the rug? Cliche much.

>take rug
Taken.

>open door
(Front Door)
That's not something you can open.

>open hidden door
You open Hidden Door.

>go hidden door
Elle grabs your hand and slowly follows you. "This is kind of creepy," she says.

Basement
You can see Elle and Mirror here.

>x mirror
You see a full body mirror on the wall, but something is not right. You don't see your reflection, only the rest of the room around you. Odd looks as if you could walk right through it.

* * *

>x real
In Real World is You.

>look
Basement
You can see Elle, Hidden Door and Mirror here.

* * *

>purloin real
[Purloined.]

>x real
In Real World is You.

>gonear basement
Basement
You can see Mirror here.

* * *

>x dimension
Other Dimension is empty.

>look
Basement
You can see Elle, Hidden Door and Mirror here.

* * *

>go up
Elle lets go of your hand and sits down on the couch. "Well that was anticlimactic," she says. "I thought maybe something cool would happen after going down there."

Living Room
You can see Hidden Door, Couch (on which is Elle) and Mail here.

>mail
That's not a verb I recognise.

>x mail
You can't see any such thing.

>x mail1
It's a letter to attend Sarah Martin's funeral next weekend.

>go down
Basement
You can see Hidden Door and Mirror here.

>go mirror
Odd Everything seems to be the same. But something definately feels different.

Elle grabs your hand and slowly follows you. "This is kind of creepy," she says.

>x real
Real World is empty.

>x dimension
In Other Dimension is You.

* * *

>dresser
That's not a verb I recognise.

>x dresser
A small dresser in your bedroom. It has one drawer.

>open dresser
You haven't unpacked your things yet. Your clothes must be in your suitcase somewhere.

>take off dirty shirt
You take off Dirty Shirt.

* * *

>take off dirty pants
You take off Dirty Pants.

>open dresser
You open the dresser drawer to reveal: nothing. And a dead spider. Boring.

>x dead spider
A dead spider. What did you think it was? A molerat? Did you really thing it would change just by looking at it closer?

>take clock
You don't need that right now.

>x clock
5:00 PM

>gonexar clock1
That's not a verb I recognise.

>gonear clock2
There seems to be no such object anywhere in the model world.

>gonear clock1
Bedroom
On Dresser is Clock.

You can also see Bed and Calender here.

>x clock
13:27

>go bedroom
You can't see any such thing.

>go bedroom1
You can't see any such thing.

>go living room1
You can't see any such thing.

>go living room
You can't see any such thing.

>w
Elle lets go of your hand and sits down on the couch. "Well that was anticlimactic," she says. "I thought maybe something cool would happen after going down there."

Living Room
You can see Hidden Door, Couch (on which is Elle), Front Door and Mail here.

* * *

>x dresser
(Dresser)
A small dresser in your bedroom. There is one big dresser drawer.

On Dresser is Clock.

>x bed
Just a cheap matress. You don't have money to spare buying some fancy sleep number bed or whatever it is.

>take mattress
You can't see any such thing.

>take matress
You can't see any such thing.

>x matress
You can't see any such thing.

>eat bed
(first taking Bed)
You'd have to get off Bed first.

>get off bed
You'd better get into some clean clothes before Ellie gets here.

>eat bed
(first taking Bed)
That's fixed in place.

>l
Bedroom
The Living Room is east.

On Dresser is Clock.

You can also see Bed and Calender here.

>x clock
5:00 PM

>take clock
Taken.

>x calender
March 8, 2013

>take calender
Taken.

>l
Bedroom
The Living Room is east.

You can see Bed here.

>e
Living Room
The Bedroom is west. The Kitchen is east. The Front Door is north.

You can see Suitcase (closed), Front Door, Rug and Couch here.

>x suitcase
The biggest suitcase you own filled with everything you could fit inside.

>open suitcase
You open Suitcase, revealing Clean Shirt and Clean Pants.

>x shirt
(Dirty Shirt)
You see nothing special about Dirty Shirt.

>x clean shirt
You see nothing special about Clean Shirt.

>x clean pants
You see nothing special about Clean Pants.

>x self
 You are wearing a dirty shirt.  You are wearing dirty pants.

>x dirty pants
You see nothing special about Dirty Pants.

>put on clean shirt
(first taking Clean Shirt)

>x self
 You are wearing a dirty shirt.  You are wearing dirty pants.  You are wearing a clean shirt.

>take off dirty shirt
You take off Dirty Shirt.

>take off dirty pants (slowly)
You can't see any such thing.

>take off dirty pants
You take off Dirty Pants.

>put on clean pants
(first taking Clean Pants)

 You hear the doorbell ring.

>l
Living Room
The Bedroom is west. The Kitchen is east. The Front Door is north.

You can see Suitcase (empty), Front Door, Rug and Couch here.

>x front door
You see nothing special about Front Door.

>x rug
A hidden door under the rug? Cliche much.

>x rug
There is a rug on the floor in the living room. You don't know why but this rug seems really out of place.

>x couch
You see nothing special about Couch.

>sit on couch
You get onto Couch.

>get off couch
You get off Couch.

Living Room
The Bedroom is west. The Kitchen is east. The Front Door is north.

You can see Suitcase (empty), Front Door, Rug and Couch here.

>n
(first opening Front Door)
You open the front door and see Elle standing there. 

"Hey you, got your mail," she says, smiling before walking in and looking around. "Not the nicest place in the world," she remarks, "but I'm glad you finally found one-Ah!"

 She suddenly trips on the rug and drops the mail in her hand. You rush over and help her up. "Sorry about that," she laughs. "We should probably do something about the rug though. If not knowing me this'll definately happen again."

>x mail
Sarah Martin is a friend of Elle's. She's inviting you two to a party next weekend. You don't like her much but don't mind going along so long as you're with Elle.

>x elle
You see nothing special about Elle.

>x sarah martin
You can't see any such thing.

>l
Living Room
The Bedroom is west. The Kitchen is east. The Front Door is north.

You can see Mail, Elle, Suitcase (empty), Front Door, Rug and Couch here.

>take rug
A hidden door under the rug? Cliche much.

>l
Living Room
The Bedroom is west. The Kitchen is east. The Front Door is north.

You can see Mail, Elle, Suitcase (empty), Front Door, Rug and Couch here.

>d
(first opening Hidden Door)
Elle grabs your hand and slowly follows you. "This is kind of creepy," she says.

Basement
You can see Elle and Mirror here.

>x mirror
You see a full body mirror on the wall, but something is not right. You don't see your reflection, only the rest of the room around you. Odd looks as if you could walk right through it.

>enter mirror
Odd Everything seems to be the same. But something definately feels different.

>l
Basement
You can see Elle, Hidden Door and Mirror here.

>(you walk through the mirror into a room exactly like the one you just left. But something definately feels different.)
That's not a verb I recognise.

>u
Elle lets go of your hand and sits down on the couch. "Well that was anticlimactic," she says. "I thought maybe something cool would happen after going down there."

Living Room
You can see Hidden Door, Couch (on which is Elle) and Mail here.

>x mail
It's a letter to attend Sarah Martin's funeral next weekend.

>x couch
You can't see any such thing.

>x door
You can't see any such thing.

>no front door
I only understood you as far as wanting to no.

>no bedroom
I only understood you as far as wanting to no.

>e
Bedroom
On Dresser is Clock.

You can also see Bed and Calender here.

>x clock
5:00 PM

>x bed
You can't see any such thing.

>x calender
March 8, 2013