You've just arrived at your new house a couple of hours ago but instantly crashed on your new bed when you got there. You just woke up from your nap and realized it's already 5:00 pm. Your girlfriend Ellie was going to come over to see the new place. You'd better start actually looking around your new place. It's a little run down but hey, what did you expect from craigslist. Too bad you can't afford a nicer place yet.

Inform Final Project
An Interactive Fiction by Nolan Chung
Release 1 / Serial number 130306 / Inform 7 build 6G60 (I6/v6.32 lib 6/12N) SD

Bedroom
The Living Room is east.

>down
You can't go that way.

>x stairs
You see nothing special about Stairs.

>go stairs
(first opening Stairs)
You can't, since Stairs leads nowhere.

* * *

You've just arrived at your new house a couple of hours ago but instantly crashed on your new bed when you got there. You just woke up from your nap and realized it's already 5:00 pm. Your girlfriend Ellie was going to come over to see the new place. You'd better start actually looking around your new place. It's a little run down but hey, what did you expect from craigslist. Too bad you can't afford a nicer place yet.

Inform Final Project
An Interactive Fiction by Nolan Chung
Release 1 / Serial number 130306 / Inform 7 build 6G60 (I6/v6.32 lib 6/12N) SD

Bedroom
The Living Room is east.

>e
Living Room
The Bedroom is west. The Kitchen is east.

You can see Rug here.

>down
You can't go that way.

>take rug
Taken.

>x rug
A hidden door under the rug? Cliche much.

* * *

>e
Living Room
The Bedroom is west. The Kitchen is east.

You can see Rug here.

>e
Kitchen
The Living Room is west.

>w
Living Room
The Bedroom is west. The Kitchen is east.

You can see Rug here.

>x rug
A hidden door under the rug? Cliche much.

>take rug
A hidden door under the rug? Cliche much.

>drop rug
Rug is already here.

* * *

>e
Living Room
The Bedroom is west. The Kitchen is east.

You can see Rug here.

>take rug
A hidden door under the rug? Cliche much.

>down
(first opening Hidden Door)

Basement
You can see Mirror here.

>x mirror
You see a full body mirror on the wall, but something is not right. You don't see your reflection, only the rest of the room around you. Odd looks as if you could walk right through it.

>go mirror
(first opening Mirror)
Odd Everything seems to be the same. But something definately feels different, but you can't tell what.

>up
(first opening Hidden Door)

Living Room
You can see Hidden Door here.

>down
Basement
You can see Hidden Door and Mirror here.

>e
You can't go that way.

>n
You can't go that way.

>s
You can't go that way.

>w
Odd Everything seems to be the same. But something definately feels different, but you can't tell what.

>e
Odd Everything seems to be the same. But something definately feels different, but you can't tell what.

>up
Living Room
You can see Hidden Door here.

>up
You can't go that way.

* * *

>take rug
A hidden door under the rug? Cliche much.

>move rug
Nothing obvious happens.

* * *

>x rug
A hidden door under the rug? Cliche much.

>take rug
A hidden door under the rug? Cliché much.

>x rug
You see nothing special about Rug.

* * *

>x rug
A hidden door under the rug? Cliche much.

>go hidden door
(first opening Hidden Door)

Basement
You can see Mirror here.

>x mirror
You see a full body mirror on the wall, but something is not right. You don't see your reflection, only the rest of the room around you. Odd looks as if you could walk right through it.

>go mirror
(first opening Mirror)
You can't, since Mirror leads nowhere.

* * *

You've just arrived at your new house a couple of hours ago but instantly crashed on your new bed when you got there. You just woke up from your nap and realized it's already 5:00 pm. Your girlfriend Ellie was going to come over to see the new place. You'd better start actually looking around your new place. It's a little run down but hey, what did you expect from craigslist. Too bad you can't afford a nicer place yet.

Inform Final Project
An Interactive Fiction by Nolan Chung
Release 1 / Serial number 130306 / Inform 7 build 6G60 (I6/v6.32 lib 6/12N) SD

Bedroom
The Living Room is east.

>x east
You see nothing unexpected in that direction.

* * *

You've just arrived at your new house a couple of hours ago but instantly crashed on your new bed when you got there. You just woke up from your nap and realized it's already 5:00 pm. Your girlfriend Ellie was going to come over to see the new place. You'd better start actually looking around your new place. It's a little run down but hey, what did you expect from craigslist. Too bad you can't afford a nicer place yet.

Inform Final Project
An Interactive Fiction by Nolan Chung
Release 1 / Serial number 130306 / Inform 7 build 6G60 (I6/v6.32 lib 6/12N) SD

Bedroom
The Living Room is east.

>x rug
You can't see any such thing.

* * *

>x rug
[Rule "standard examining rule" applies.]
[Rule "examine directions rule" applies.]
[Rule "examine containers rule" applies.]
[Rule "examine supporters rule" applies.]
[Rule "examine devices rule" applies.]
[Rule "examine undescribed things rule" applies.]
You see nothing special about Rug.

[Rule "report other people examining rule" applies.]

>take rug
[Rule "Instead of taking rug for the first time" applies.]
A hidden door under the rug? Cliché much.